"","state","number","coc_name","total_homeless","sheltered_homeless","unsheltered_homeless","total_in_families","sheltered_in_families","unsheltered_in_families","total_households","sheltered_households","unsheltered_households","year","total_chronic","sheltered_chronic","unsheltered_chronic","total_veterans","sheltered_veterans","unsheltered_veterans","youth","coc_category"
"1","AK","500","Anchorage CoC",974,842,132,278,253,25,93,85,8,2007,NA,NA,NA,NA,NA,NA,NA,NA
"2","AK","501","Alaska Balance of State CoC",668,545,123,302,243,59,97,80,17,2007,NA,NA,NA,NA,NA,NA,NA,NA
"3","AL","500","Birmingham/Jefferson, St. Clair, Shelby Counties CoC",2104,1240,864,575,407,168,228,153,75,2007,NA,NA,NA,NA,NA,NA,NA,NA
"4","AL","501","Mobile City & County/Baldwin County CoC",649,410,239,150,150,0,48,48,0,2007,NA,NA,NA,NA,NA,NA,NA,NA
"5","AL","502","Florence/Northwest Alabama CoC",265,131,134,122,38,84,38,10,28,2007,NA,NA,NA,NA,NA,NA,NA,NA
"6","AL","503","Huntsville/North Alabama CoC",830,756,74,69,69,0,25,25,0,2007,NA,NA,NA,NA,NA,NA,NA,NA
"7","AL","504","Montgomery City & County CoC",456,331,125,64,61,3,25,24,1,2007,NA,NA,NA,NA,NA,NA,NA,NA
"8","AL","505","Gadsden/Northeast Alabama CoC",119,104,15,16,14,2,6,5,1,2007,NA,NA,NA,NA,NA,NA,NA,NA
"9","AL","506","Tuscaloosa City & County CoC",345,332,13,51,47,4,10,9,1,2007,NA,NA,NA,NA,NA,NA,NA,NA
"10","AL","507","Alabama Balance of State CoC",684,492,192,221,187,34,86,73,13,2007,NA,NA,NA,NA,NA,NA,NA,NA
"11","AR","500","Little Rock/Central Arkansas CoC",1822,1187,635,190,178,12,61,58,3,2007,NA,NA,NA,NA,NA,NA,NA,NA
"12","AR","501","Fayetteville/Northwest Arkansas CoC",279,244,35,122,111,11,47,43,4,2007,NA,NA,NA,NA,NA,NA,NA,NA
"13","AR","502","Conway/Arkansas River Valley",163,59,104,76,40,36,26,17,9,2007,NA,NA,NA,NA,NA,NA,NA,NA
"14","AR","504","Delta Hills CoC",901,391,510,275,44,231,127,17,110,2007,NA,NA,NA,NA,NA,NA,NA,NA
"15","AR","505","Southeast Arkansas CoC",130,120,10,95,88,7,24,22,2,2007,NA,NA,NA,NA,NA,NA,NA,NA
"16","AR","506","Johnson, Pope, Yell Counties",21,18,3,0,0,0,0,0,0,2007,NA,NA,NA,NA,NA,NA,NA,NA
"17","AR","508","Fort Smith CoC",194,147,47,37,36,1,17,16,1,2007,NA,NA,NA,NA,NA,NA,NA,NA
"18","AR","509","Hot Springs/South West Arkansas CoC",4,2,2,0,0,0,0,0,0,2007,NA,NA,NA,NA,NA,NA,NA,NA
"19","AR","510","Hempstead, Sevier, Howard, Little River  Counties CoC",322,117,205,54,22,32,22,11,11,2007,NA,NA,NA,NA,NA,NA,NA,NA
"20","AZ","500","Arizona Balance of State CoC",2997,1013,1984,762,481,281,274,158,116,2007,NA,NA,NA,NA,NA,NA,NA,NA
"21","AZ","501","Tucson/Pima County CoC",3201,2010,1191,943,851,92,301,269,32,2007,NA,NA,NA,NA,NA,NA,NA,NA
"22","AZ","502","Phoenix, Mesa/Maricopa County CoC",8448,5595,2853,2921,2863,58,884,864,20,2007,NA,NA,NA,NA,NA,NA,NA,NA
"23","CA","500","San Jose/Santa Clara City & County CoC",7202,2101,5101,1257,996,261,326,297,29,2007,NA,NA,NA,NA,NA,NA,NA,NA
"24","CA","501","San Francisco CoC",5703,2912,2791,532,512,20,194,186,8,2007,NA,NA,NA,NA,NA,NA,NA,NA
"25","CA","502","Oakland, Berkeley/Alameda County CoC",4838,2342,2496,1812,1085,727,653,369,284,2007,NA,NA,NA,NA,NA,NA,NA,NA
"26","CA","503","Sacramento City & County CoC",2452,1447,1005,487,465,22,163,157,6,2007,NA,NA,NA,NA,NA,NA,NA,NA
"27","CA","504","Santa Rosa, Petaluma/Sonoma County CoC",1314,782,532,426,375,51,149,126,23,2007,NA,NA,NA,NA,NA,NA,NA,NA
"28","CA","505","Richmond/Contra Costa County CoC",4062,903,3159,1170,571,599,344,198,146,2007,NA,NA,NA,NA,NA,NA,NA,NA
"29","CA","506","Salinas/Monterey, San Benito Counties CoC",1402,509,893,253,247,6,79,77,2,2007,NA,NA,NA,NA,NA,NA,NA,NA
"30","CA","507","Marin County CoC",1002,602,400,156,137,19,52,43,9,2007,NA,NA,NA,NA,NA,NA,NA,NA
"31","CA","508","Watsonville/Santa Cruz City & County CoC",2789,486,2303,381,225,156,127,74,53,2007,NA,NA,NA,NA,NA,NA,NA,NA
"32","CA","509","Mendocino County CoC",1422,284,1138,230,120,110,152,42,110,2007,NA,NA,NA,NA,NA,NA,NA,NA
"33","CA","510","Turlock, Modesto/Stanislaus County CoC",1593,634,959,592,352,240,198,117,81,2007,NA,NA,NA,NA,NA,NA,NA,NA
"34","CA","511","Stockton/San Joaquin County CoC",2479,2176,303,822,759,63,264,225,39,2007,NA,NA,NA,NA,NA,NA,NA,NA
"35","CA","512","Daly/San Mateo County CoC",1798,704,1094,410,394,16,126,122,4,2007,NA,NA,NA,NA,NA,NA,NA,NA
"36","CA","513","Visalia/Kings, Tulare Counties CoC",1106,280,826,569,112,457,152,37,115,2007,NA,NA,NA,NA,NA,NA,NA,NA
"37","CA","514","Fresno City & County/Madera County CoC",4247,2735,1512,1581,706,875,488,301,187,2007,NA,NA,NA,NA,NA,NA,NA,NA
"38","CA","515","Roseville, Rocklin/Placer, Nevada Counties CoC",587,450,137,219,206,13,60,56,4,2007,NA,NA,NA,NA,NA,NA,NA,NA
"39","CA","516","Redding/Shasta, Siskiyou, Lassen, Plumas, Del Norte, Modoc, Sierra Counties CoC",296,250,46,149,129,20,49,39,10,2007,NA,NA,NA,NA,NA,NA,NA,NA
"40","CA","517","Napa City & County CoC",365,219,146,129,105,24,32,24,8,2007,NA,NA,NA,NA,NA,NA,NA,NA
"41","CA","518","Vallejo/Solano County CoC",1956,457,1499,1138,232,906,475,113,362,2007,NA,NA,NA,NA,NA,NA,NA,NA
"42","CA","519","Chico, Paradise/Butte County CoC",1478,936,542,421,347,74,134,91,43,2007,NA,NA,NA,NA,NA,NA,NA,NA
"43","CA","520","Merced City & County CoC",2641,221,2420,446,35,411,131,10,121,2007,NA,NA,NA,NA,NA,NA,NA,NA
"44","CA","521","Davis, Woodland/Yolo County CoC",414,228,186,122,118,4,37,36,1,2007,NA,NA,NA,NA,NA,NA,NA,NA
"45","CA","522","Humboldt County CoC",907,322,585,541,183,358,146,57,89,2007,NA,NA,NA,NA,NA,NA,NA,NA
"46","CA","523","Colusa, Glenn, Trinity Counties CoC",155,54,101,94,36,58,24,10,14,2007,NA,NA,NA,NA,NA,NA,NA,NA
"47","CA","524","Yuba City & County/Sutter County CoC",362,299,63,150,146,4,45,43,2,2007,NA,NA,NA,NA,NA,NA,NA,NA
"48","CA","525","El Dorado County CoC",107,91,16,42,37,5,12,11,1,2007,NA,NA,NA,NA,NA,NA,NA,NA
"49","CA","526","Amador, Calaveras, Mariposa, Tuolumne Counties CoC",400,79,321,148,53,95,51,19,32,2007,NA,NA,NA,NA,NA,NA,NA,NA
"50","CA","600","Los Angeles City & County CoC",47862,11442,36420,3677,3025,652,1165,909,256,2007,NA,NA,NA,NA,NA,NA,NA,NA
"51","CA","601","San Diego City and County CoC",7326,3981,3345,2031,1636,395,685,566,119,2007,NA,NA,NA,NA,NA,NA,NA,NA
"52","CA","602","Santa Ana, Anaheim/Orange County CoC",3649,2578,1071,1537,1282,255,513,439,74,2007,NA,NA,NA,NA,NA,NA,NA,NA
"53","CA","603","Santa Maria/Santa Barbara County CoC",4253,1480,2773,1041,769,272,245,178,67,2007,NA,NA,NA,NA,NA,NA,NA,NA
"54","CA","604","Bakersfield/Kern County CoC",1537,905,632,289,259,30,89,83,6,2007,NA,NA,NA,NA,NA,NA,NA,NA
"55","CA","606","Long Beach CoC",3829,1679,2150,1015,490,525,320,163,157,2007,NA,NA,NA,NA,NA,NA,NA,NA
"56","CA","607","Pasadena CoC",969,434,535,293,136,157,74,35,39,2007,NA,NA,NA,NA,NA,NA,NA,NA
"57","CA","608","Riverside City & County CoC",4508,1330,3178,1165,718,447,338,205,133,2007,NA,NA,NA,NA,NA,NA,NA,NA
"58","CA","609","San Bernardino City & County CoC",6969,1220,5749,778,611,167,237,192,45,2007,NA,NA,NA,NA,NA,NA,NA,NA
"59","CA","611","Oxnard, San Buenaventura/Ventura County CoC",1961,426,1535,448,179,269,132,52,80,2007,NA,NA,NA,NA,NA,NA,NA,NA
"60","CA","612","Glendale CoC",296,233,63,135,110,25,50,42,8,2007,NA,NA,NA,NA,NA,NA,NA,NA
"61","CA","613","Imperial County CoC",342,113,229,288,59,229,29,29,0,2007,NA,NA,NA,NA,NA,NA,NA,NA
"62","CA","614","San Luis Obispo County CoC",2408,187,2221,1060,57,1003,193,22,171,2007,NA,NA,NA,NA,NA,NA,NA,NA
"63","CO","500","Colorado Balance of State CoC",4450,1093,3357,1817,642,1175,613,251,362,2007,NA,NA,NA,NA,NA,NA,NA,NA
"64","CO","503","Metropolitan Denver CoC",8698,5185,3513,5249,3016,2233,1994,1106,888,2007,NA,NA,NA,NA,NA,NA,NA,NA
"65","CO","504","Colorado Springs/El Paso County CoC",1077,693,384,315,259,56,97,75,22,2007,NA,NA,NA,NA,NA,NA,NA,NA
"66","CT","503","Bridgeport, Stamford, Norwalk/Fairfield County CoC",919,789,130,292,285,7,93,90,3,2007,NA,NA,NA,NA,NA,NA,NA,NA
"67","CT","505","Connecticut Balance of State CoC",3563,2882,681,1017,930,87,349,314,35,2007,NA,NA,NA,NA,NA,NA,NA,NA
"68","DE","500","Delaware Statewide CoC",1061,854,207,345,324,21,119,111,8,2007,NA,NA,NA,NA,NA,NA,NA,NA
"69","FL","500","Sarasota, Bradenton/Manatee, Sarasota Counties CoC",1012,494,518,235,152,83,79,45,34,2007,NA,NA,NA,NA,NA,NA,NA,NA
"70","FL","501","Tampa/Hillsborough County CoC",6483,1050,5433,2086,466,1620,837,148,689,2007,NA,NA,NA,NA,NA,NA,NA,NA
"71","FL","502","St. Petersburg, Clearwater, Largo/Pinellas County CoC",2526,1305,1221,397,394,3,151,150,1,2007,NA,NA,NA,NA,NA,NA,NA,NA
"72","FL","503","Lakeland, Winterhaven/Polk County CoC",802,487,315,209,151,58,63,48,15,2007,NA,NA,NA,NA,NA,NA,NA,NA
"73","FL","504","Daytona Beach, Daytona/Volusia, Flagler Counties CoC",1478,569,909,624,366,258,304,218,86,2007,NA,NA,NA,NA,NA,NA,NA,NA
"74","FL","505","Fort Walton Beach/Okaloosa, Walton Counties CoC",2179,105,2074,986,54,932,442,24,418,2007,NA,NA,NA,NA,NA,NA,NA,NA
"75","FL","506","Tallahassee/Leon County CoC",590,495,95,156,131,25,44,37,7,2007,NA,NA,NA,NA,NA,NA,NA,NA
"76","FL","507","Orlando/Orange, Osceola, Seminole Counties CoC",3823,2003,1820,1814,764,1050,544,224,320,2007,NA,NA,NA,NA,NA,NA,NA,NA
"77","FL","508","Gainesville/Alachua, Putnam Counties CoC",678,263,415,89,82,7,39,33,6,2007,NA,NA,NA,NA,NA,NA,NA,NA
"78","FL","509","Fort Pierce/St. Lucie, Indian River, Martin Counties CoC",1734,458,1276,762,313,449,398,107,291,2007,NA,NA,NA,NA,NA,NA,NA,NA
"79","FL","510","Jacksonville-Duval, Clay Counties CoC",2743,1585,1158,506,498,8,250,248,2,2007,NA,NA,NA,NA,NA,NA,NA,NA
"80","FL","511","Pensacola/Escambia, Santa Rosa Counties CoC",629,347,282,261,137,124,104,64,40,2007,NA,NA,NA,NA,NA,NA,NA,NA
"81","FL","512","St. Johns County CoC",1238,106,1132,139,70,69,50,33,17,2007,NA,NA,NA,NA,NA,NA,NA,NA
"82","FL","513","Palm Bay, Melbourne/Brevard County CoC",1899,502,1397,367,201,166,115,59,56,2007,NA,NA,NA,NA,NA,NA,NA,NA
"83","FL","514","Ocala/Marion County CoC",480,312,168,132,132,0,45,45,0,2007,NA,NA,NA,NA,NA,NA,NA,NA
"84","FL","515","Panama City/Bay, Jackson Counties CoC",313,211,102,44,44,0,12,12,0,2007,NA,NA,NA,NA,NA,NA,NA,NA
"85","FL","517","Hendry, Hardee, Highlands Counties CoC",904,664,240,0,0,0,0,0,0,2007,NA,NA,NA,NA,NA,NA,NA,NA
"86","FL","518","Columbia, Hamilton, Lafayette, Suwannee Counties CoC",250,85,165,101,32,69,19,8,11,2007,NA,NA,NA,NA,NA,NA,NA,NA
"87","FL","519","Pasco County CoC",2260,1379,881,1827,1133,694,831,515,316,2007,NA,NA,NA,NA,NA,NA,NA,NA
"88","FL","520","Citrus, Hernando, Lake, Sumter Counties CoC",2019,192,1827,1174,48,1126,378,19,359,2007,NA,NA,NA,NA,NA,NA,NA,NA
"89","FL","600","Miami-Dade County CoC",4392,3012,1380,1229,1227,2,347,346,1,2007,NA,NA,NA,NA,NA,NA,NA,NA
"90","FL","601","Ft Lauderdale/Broward County CoC",3154,2453,701,703,639,64,178,155,23,2007,NA,NA,NA,NA,NA,NA,NA,NA
"91","FL","602","Punta Gorda/Charlotte County CoC",730,450,280,95,88,7,46,44,2,2007,NA,NA,NA,NA,NA,NA,NA,NA
"92","FL","603","Ft Myers, Cape Coral/Lee County CoC",2382,433,1949,424,59,365,123,11,112,2007,NA,NA,NA,NA,NA,NA,NA,NA
"93","FL","604","Monroe County CoC",1121,477,644,104,67,37,37,27,10,2007,NA,NA,NA,NA,NA,NA,NA,NA
"94","FL","605","West Palm Beach/Palm Beach County CoC",1766,727,1039,464,413,51,150,133,17,2007,NA,NA,NA,NA,NA,NA,NA,NA
"95","FL","606","Naples/Collier County CoC",484,365,119,101,96,5,32,30,2,2007,NA,NA,NA,NA,NA,NA,NA,NA
"96","GA","500","Atlanta CoC",6840,4725,2115,1218,1174,44,379,365,14,2007,NA,NA,NA,NA,NA,NA,NA,NA
"97","GA","501","Georgia Balance of State CoC",10255,1971,8284,5227,880,4347,1550,308,1242,2007,NA,NA,NA,NA,NA,NA,NA,NA
"98","GA","503","Athens-Clarke County CoC",464,333,131,160,152,8,53,50,3,2007,NA,NA,NA,NA,NA,NA,NA,NA
"99","GA","504","Augusta-Richmond County CoC",489,451,38,116,112,4,40,39,1,2007,NA,NA,NA,NA,NA,NA,NA,NA
"100","GA","505","Columbus-Muscogee/Russell County CoC",540,188,352,127,42,85,49,15,34,2007,NA,NA,NA,NA,NA,NA,NA,NA
"101","GA","506","Marietta/Cobb County CoC",537,329,208,191,169,22,69,61,8,2007,NA,NA,NA,NA,NA,NA,NA,NA
"102","GA","507","Savannah/Chatham County CoC",514,344,170,79,69,10,37,27,10,2007,NA,NA,NA,NA,NA,NA,NA,NA
"103","HI","500","Hawaii Balance of State CoC",2320,755,1565,1075,409,666,296,121,175,2007,NA,NA,NA,NA,NA,NA,NA,NA
"104","HI","501","Honolulu City and County CoC",3750,1957,1793,1660,1203,457,438,323,115,2007,NA,NA,NA,NA,NA,NA,NA,NA
"105","IA","500","Sioux City/Dakota, Woodbury Counties CoC",164,159,5,42,42,0,17,17,0,2007,NA,NA,NA,NA,NA,NA,NA,NA
"106","IA","501","Iowa Balance of State CoC",1529,1340,189,851,813,38,305,287,18,2007,NA,NA,NA,NA,NA,NA,NA,NA
"107","IA","502","Des Moines/Polk County CoC",1041,942,99,337,332,5,105,104,1,2007,NA,NA,NA,NA,NA,NA,NA,NA
"108","ID","500","Boise/Ada County CoC",581,472,109,171,165,6,57,55,2,2007,NA,NA,NA,NA,NA,NA,NA,NA
"109","ID","501","Idaho Balance of State CoC",1168,653,515,476,347,129,153,120,33,2007,NA,NA,NA,NA,NA,NA,NA,NA
"110","IL","500","McHenry County CoC",253,235,18,70,63,7,24,21,3,2007,NA,NA,NA,NA,NA,NA,NA,NA
"111","IL","501","Rockford/Winnebago, Boone Counties CoC",575,525,50,254,249,5,91,89,2,2007,NA,NA,NA,NA,NA,NA,NA,NA
"112","IL","502","Waukegan, North Chicago/Lake County CoC",496,486,10,256,256,0,82,82,0,2007,NA,NA,NA,NA,NA,NA,NA,NA
"113","IL","503","Champaign, Urbana, Rantoul/Champaign County CoC",429,416,13,271,260,11,102,98,4,2007,NA,NA,NA,NA,NA,NA,NA,NA
"114","IL","504","Madison County CoC",240,203,37,163,157,6,51,48,3,2007,NA,NA,NA,NA,NA,NA,NA,NA
"115","IL","506","Joliet, Bolingbrook/Will County CoC",397,379,18,153,150,3,60,59,1,2007,NA,NA,NA,NA,NA,NA,NA,NA
"116","IL","507","Peoria, Pekin/Fulton, Tazewell, Peoria, Woodford Counties CoC",434,336,98,99,99,0,30,30,0,2007,NA,NA,NA,NA,NA,NA,NA,NA
"117","IL","508","East St. Louis, Belleville/St. Clair County CoC",799,442,357,513,296,217,160,73,87,2007,NA,NA,NA,NA,NA,NA,NA,NA
"118","IL","509","Dekalb City & County CoC",130,106,24,70,58,12,23,19,4,2007,NA,NA,NA,NA,NA,NA,NA,NA
"119","IL","510","Chicago CoC",5979,4346,1633,2052,1987,65,598,576,22,2007,NA,NA,NA,NA,NA,NA,NA,NA
"120","IL","511","Cook County CoC",1420,1162,258,699,690,9,328,325,3,2007,NA,NA,NA,NA,NA,NA,NA,NA
"121","IL","512","Bloomington/Central Illinois CoC",467,399,68,239,214,25,73,67,6,2007,NA,NA,NA,NA,NA,NA,NA,NA
"122","IL","513","Springfield/Sangamon County CoC",260,245,15,164,164,0,94,94,0,2007,NA,NA,NA,NA,NA,NA,NA,NA
"123","IL","514","DuPage County CoC",766,642,124,386,364,22,131,123,8,2007,NA,NA,NA,NA,NA,NA,NA,NA
"124","IL","515","South Central Illinois CoC",246,214,32,188,164,24,63,55,8,2007,NA,NA,NA,NA,NA,NA,NA,NA
"125","IL","516","Decatur/Macon County CoC",347,167,180,223,102,121,73,37,36,2007,NA,NA,NA,NA,NA,NA,NA,NA
"126","IL","517","Aurora, Elgin/Kane County CoC",474,418,56,118,118,0,36,36,0,2007,NA,NA,NA,NA,NA,NA,NA,NA
"127","IL","518","Rock Island, Moline/Northwestern Illinois CoC",600,506,94,392,309,83,104,79,25,2007,NA,NA,NA,NA,NA,NA,NA,NA
"128","IL","519","West Central Illinois CoC",305,148,157,70,51,19,27,18,9,2007,NA,NA,NA,NA,NA,NA,NA,NA
"129","IL","520","Southern Illinois CoC",870,796,74,454,438,16,123,117,6,2007,NA,NA,NA,NA,NA,NA,NA,NA
"130","IN","502","Indiana Balance of State CoC",5490,4462,1028,2083,1931,152,714,673,41,2007,NA,NA,NA,NA,NA,NA,NA,NA
"131","IN","503","Indianapolis CoC",1868,1634,234,541,541,0,149,149,0,2007,NA,NA,NA,NA,NA,NA,NA,NA
"132","KS","502","Wichita/Sedgwick County CoC",526,473,53,158,157,1,51,50,1,2007,NA,NA,NA,NA,NA,NA,NA,NA
"133","KS","503","Topeka/Shawnee County CoC",227,226,1,128,128,0,38,38,0,2007,NA,NA,NA,NA,NA,NA,NA,NA
"134","KS","505","Overland Park, Shawnee/Johnson County CoC",234,147,87,174,130,44,50,40,10,2007,NA,NA,NA,NA,NA,NA,NA,NA
"135","KS","507","Kansas Balance of State CoC",937,853,84,383,356,27,126,116,10,2007,NA,NA,NA,NA,NA,NA,NA,NA
"136","KY","500","Kentucky Balance of State CoC",4316,2421,1895,2813,1650,1163,849,509,340,2007,NA,NA,NA,NA,NA,NA,NA,NA
"137","KY","501","Louisville-Jefferson County CoC",2587,2407,180,946,946,0,332,332,0,2007,NA,NA,NA,NA,NA,NA,NA,NA
"138","KY","502","Lexington-Fayette County CoC",1158,1112,46,412,410,2,186,185,1,2007,NA,NA,NA,NA,NA,NA,NA,NA
"139","LA","500","Lafayette/Acadiana CoC",631,457,174,326,243,83,104,79,25,2007,NA,NA,NA,NA,NA,NA,NA,NA
"140","LA","502","Shreveport, Bossier/Northwest Louisiana CoC",857,723,134,353,282,71,118,97,21,2007,NA,NA,NA,NA,NA,NA,NA,NA
"141","LA","503","New Orleans/Jefferson Parish CoC",1619,990,629,818,486,332,262,159,103,2007,NA,NA,NA,NA,NA,NA,NA,NA
"142","LA","505","Monroe/Northeast Louisiana CoC",313,262,51,193,156,37,59,48,11,2007,NA,NA,NA,NA,NA,NA,NA,NA
"143","LA","506","Slidell/Southeast Louisiana CoC",434,203,231,263,137,126,83,46,37,2007,NA,NA,NA,NA,NA,NA,NA,NA
"144","LA","507","Alexandria/Central Louisiana CoC",188,140,48,79,68,11,28,23,5,2007,NA,NA,NA,NA,NA,NA,NA,NA
"145","LA","509","Louisiana Balance of State CoC",1452,1142,310,489,390,99,178,148,30,2007,NA,NA,NA,NA,NA,NA,NA,NA
"146","MA","500","Boston CoC",5104,4798,306,2156,2156,0,771,771,0,2007,NA,NA,NA,NA,NA,NA,NA,NA
"147","MA","501","Holyoke/Franklin, Hampden, Hampshire Counties CoC",964,911,53,547,547,0,156,156,0,2007,NA,NA,NA,NA,NA,NA,NA,NA
"148","MA","502","Lynn CoC",236,208,28,66,66,0,26,26,0,2007,NA,NA,NA,NA,NA,NA,NA,NA
"149","MA","503","Cape Cod Islands CoC",697,368,329,289,198,91,119,86,33,2007,NA,NA,NA,NA,NA,NA,NA,NA
"150","MA","504","Springfield/Hampden County CoC",1053,1020,33,324,324,0,116,116,0,2007,NA,NA,NA,NA,NA,NA,NA,NA
"151","MA","505","New Bedford CoC",390,356,34,81,81,0,23,23,0,2007,NA,NA,NA,NA,NA,NA,NA,NA
"152","MA","506","Worcester City & County CoC",1302,1268,34,625,617,8,239,235,4,2007,NA,NA,NA,NA,NA,NA,NA,NA
"153","MA","507","Pittsfield/Berkshire, Franklin, Hampshire Counties CoC",374,315,59,168,141,27,60,49,11,2007,NA,NA,NA,NA,NA,NA,NA,NA
"154","MA","508","Lowell CoC",432,418,14,224,224,0,75,75,0,2007,NA,NA,NA,NA,NA,NA,NA,NA
"155","MA","509","Cambridge CoC",432,376,56,86,86,0,33,33,0,2007,NA,NA,NA,NA,NA,NA,NA,NA
"156","MA","510","Gloucester, Haverhill, Salem/Essex County CoC",606,584,22,278,278,0,98,98,0,2007,NA,NA,NA,NA,NA,NA,NA,NA
"157","MA","511","Quincy, Brockton, Weymouth, Plymouth City and County CoC",934,819,115,515,515,0,184,184,0,2007,NA,NA,NA,NA,NA,NA,NA,NA
"158","MA","514","Framingham/Waltham CoC",747,575,172,522,369,153,196,135,61,2007,NA,NA,NA,NA,NA,NA,NA,NA
"159","MA","515","Fall River CoC",153,139,14,45,45,0,18,18,0,2007,NA,NA,NA,NA,NA,NA,NA,NA
"160","MA","516","Massachusetts Balance of State CoC",1200,1133,67,710,691,19,282,275,7,2007,NA,NA,NA,NA,NA,NA,NA,NA
"161","MA","517","Somerville CoC",211,196,15,74,74,0,33,33,0,2007,NA,NA,NA,NA,NA,NA,NA,NA
"162","MA","519","Attleboro, Taunton/Bristol County CoC",292,229,63,125,122,3,39,38,1,2007,NA,NA,NA,NA,NA,NA,NA,NA
"163","MD","500","Cumberland/Allegany County CoC",162,141,21,84,79,5,31,29,2,2007,NA,NA,NA,NA,NA,NA,NA,NA
"164","MD","501","Baltimore CoC",2607,1978,629,954,608,346,318,213,105,2007,NA,NA,NA,NA,NA,NA,NA,NA
"165","MD","502","Harford County CoC",145,132,13,51,51,0,17,17,0,2007,NA,NA,NA,NA,NA,NA,NA,NA
"166","MD","503","Annapolis/Anne Arundel County CoC",289,218,71,135,135,0,42,42,0,2007,NA,NA,NA,NA,NA,NA,NA,NA
"167","MD","504","Howard County CoC",175,151,24,121,121,0,23,23,0,2007,NA,NA,NA,NA,NA,NA,NA,NA
"168","MD","505","Baltimore County CoC",634,576,58,442,430,12,117,114,3,2007,NA,NA,NA,NA,NA,NA,NA,NA
"169","MD","506","Carroll County CoC",174,161,13,50,48,2,19,18,1,2007,NA,NA,NA,NA,NA,NA,NA,NA
"170","MD","507","Cecil County CoC",119,117,2,42,42,0,15,15,0,2007,NA,NA,NA,NA,NA,NA,NA,NA
"171","MD","508","Charles, Calvert, St.Mary's Counties CoC",1973,302,1671,1410,148,1262,419,50,369,2007,NA,NA,NA,NA,NA,NA,NA,NA
"172","MD","509","Frederick City & County CoC",223,214,9,81,81,0,28,28,0,2007,NA,NA,NA,NA,NA,NA,NA,NA
"173","MD","510","Garrett County CoC",82,63,19,49,39,10,24,19,5,2007,NA,NA,NA,NA,NA,NA,NA,NA
"174","MD","511","Mid-Shore Regional CoC",311,139,172,111,64,47,32,19,13,2007,NA,NA,NA,NA,NA,NA,NA,NA
"175","MD","512","Hagerstown/Washington County CoC",212,209,3,108,108,0,34,34,0,2007,NA,NA,NA,NA,NA,NA,NA,NA
"176","MD","513","Wicomico, Somerset, Worcester Counties CoC",215,178,37,77,70,7,34,31,3,2007,NA,NA,NA,NA,NA,NA,NA,NA
"177","MD","600","Prince George's County CoC",1168,823,345,362,362,0,111,111,0,2007,NA,NA,NA,NA,NA,NA,NA,NA
"178","MD","601","Montgomery County CoC",1139,1016,123,499,499,0,151,151,0,2007,NA,NA,NA,NA,NA,NA,NA,NA
"179","ME","500","Maine Statewide CoC",2638,2576,62,1502,1488,14,502,497,5,2007,NA,NA,NA,NA,NA,NA,NA,NA
"180","MI","500","Michigan Balance of State CoC",2434,1424,1010,1370,916,454,456,300,156,2007,NA,NA,NA,NA,NA,NA,NA,NA
"181","MI","501","Detroit CoC",18062,4738,13324,6149,1103,5046,1520,386,1134,2007,NA,NA,NA,NA,NA,NA,NA,NA
"182","MI","502","Dearborn, Dearborn Heights, Westland/Wayne County CoC",865,618,247,352,202,150,97,54,43,2007,NA,NA,NA,NA,NA,NA,NA,NA
"183","MI","503","St. Clair Shores, Warren/Macomb County CoC",769,251,518,228,83,145,77,26,51,2007,NA,NA,NA,NA,NA,NA,NA,NA
"184","MI","504","Pontiac, Royal Oak/Oakland County CoC",1011,402,609,207,200,7,37,36,1,2007,NA,NA,NA,NA,NA,NA,NA,NA
"185","MI","505","Flint/Genesee County CoC",354,213,141,97,75,22,34,27,7,2007,NA,NA,NA,NA,NA,NA,NA,NA
"186","MI","506","Grand Rapids, Wyoming/Kent County CoC",912,807,105,450,429,21,161,146,15,2007,NA,NA,NA,NA,NA,NA,NA,NA
"187","MI","507","Portage, Kalamazoo City & County CoC",614,593,21,326,326,0,105,105,0,2007,NA,NA,NA,NA,NA,NA,NA,NA
"188","MI","508","Lansing, East Lansing/Ingham County CoC",408,391,17,203,203,0,77,77,0,2007,NA,NA,NA,NA,NA,NA,NA,NA
"189","MI","509","Washtenaw County CoC",413,357,56,128,128,0,39,39,0,2007,NA,NA,NA,NA,NA,NA,NA,NA
"190","MI","510","Saginaw City & County CoC",361,274,87,124,96,28,43,34,9,2007,NA,NA,NA,NA,NA,NA,NA,NA
"191","MI","511","Lenawee County CoC",93,85,8,48,42,6,16,14,2,2007,NA,NA,NA,NA,NA,NA,NA,NA
"192","MI","512","Grand Traverse, Antrim, Leelanau Counties CoC",241,216,25,76,76,0,26,26,0,2007,NA,NA,NA,NA,NA,NA,NA,NA
"193","MI","513","Marquette, Alger Counties CoC",37,37,0,21,21,0,8,8,0,2007,NA,NA,NA,NA,NA,NA,NA,NA
"194","MI","514","Battle Creek/Calhoun County CoC",205,117,88,65,57,8,21,17,4,2007,NA,NA,NA,NA,NA,NA,NA,NA
"195","MI","515","Monroe City & County CoC",142,131,11,33,33,0,12,12,0,2007,NA,NA,NA,NA,NA,NA,NA,NA
"196","MI","516","Norton Shores, Muskegon City & County CoC",332,147,185,180,47,133,82,20,62,2007,NA,NA,NA,NA,NA,NA,NA,NA
"197","MI","517","Jackson City & County CoC",463,282,181,277,207,70,123,102,21,2007,NA,NA,NA,NA,NA,NA,NA,NA
"198","MI","518","Livingston County CoC",63,58,5,38,38,0,13,13,0,2007,NA,NA,NA,NA,NA,NA,NA,NA
"199","MI","519","Holland/Ottawa County CoC",319,306,13,210,200,10,66,62,4,2007,NA,NA,NA,NA,NA,NA,NA,NA
"200","MI","523","Eaton County CoC",197,105,92,160,103,57,43,26,17,2007,NA,NA,NA,NA,NA,NA,NA,NA
"201","MN","500","Minneapolis/Hennepin County CoC",2984,2428,556,1473,1437,36,479,467,12,2007,NA,NA,NA,NA,NA,NA,NA,NA
"202","MN","501","Saint Paul/Ramsey County CoC",1294,1170,124,676,667,9,216,213,3,2007,NA,NA,NA,NA,NA,NA,NA,NA
"203","MN","502","Rochester/Southeast Minnesota CoC",446,413,33,303,286,17,1191,1184,7,2007,NA,NA,NA,NA,NA,NA,NA,NA
"204","MN","503","Dakota, Anoka, Washington, Scott, Carver Counties",800,664,136,659,569,90,210,186,24,2007,NA,NA,NA,NA,NA,NA,NA,NA
"205","MN","504","Northeast Minnesota CoC",232,116,116,156,100,56,49,31,18,2007,NA,NA,NA,NA,NA,NA,NA,NA
"206","MN","505","St. Cloud/Central Minnesota CoC",389,313,76,202,169,33,71,60,11,2007,NA,NA,NA,NA,NA,NA,NA,NA
"207","MN","506","Northwest Minnesota CoC",266,235,31,152,144,8,55,52,3,2007,NA,NA,NA,NA,NA,NA,NA,NA
"208","MN","508","Moorhead/West Central Minnesota CoC",242,165,77,98,90,8,35,31,4,2007,NA,NA,NA,NA,NA,NA,NA,NA
"209","MN","509","Duluth/St.Louis County CoC",501,294,207,231,189,42,75,63,12,2007,NA,NA,NA,NA,NA,NA,NA,NA
"210","MN","511","Southwest Minnesota CoC",169,80,89,104,46,58,30,14,16,2007,NA,NA,NA,NA,NA,NA,NA,NA
"211","MO","500","St. Louis County CoC",336,290,46,246,240,6,69,67,2,2007,NA,NA,NA,NA,NA,NA,NA,NA
"212","MO","501","St.Louis City CoC",1386,1173,213,586,586,0,196,196,0,2007,NA,NA,NA,NA,NA,NA,NA,NA
"213","MO","503","St. Charles City & County, Lincoln, Warren Counties CoC",498,227,271,276,114,162,110,46,64,2007,NA,NA,NA,NA,NA,NA,NA,NA
"214","MO","600","Springfield/Greene, Christian, Webster Counties CoC",518,478,40,192,192,0,65,65,0,2007,NA,NA,NA,NA,NA,NA,NA,NA
"215","MO","602","Joplin/Jasper, Newton Counties CoC",306,298,8,87,87,0,30,30,0,2007,NA,NA,NA,NA,NA,NA,NA,NA
"216","MO","603","St. Joseph/Andrew, Buchanan, DeKalb Counties CoC",100,100,0,35,35,0,10,10,0,2007,NA,NA,NA,NA,NA,NA,NA,NA
"217","MO","604a","Kansas City, Independence, Lee’s Summit/Jackson, Wyandotte Counties, MO & KS",1786,1575,211,839,811,28,246,239,7,2007,NA,NA,NA,NA,NA,NA,NA,NA
"218","MO","606","Missouri Balance of State CoC",1504,1126,378,710,566,144,262,196,66,2007,NA,NA,NA,NA,NA,NA,NA,NA
"219","MS","500","Jackson/Rankin, Madison Counties CoC",718,440,278,92,92,0,27,27,0,2007,NA,NA,NA,NA,NA,NA,NA,NA
"220","MS","501","Mississippi Balance of State CoC",385,344,41,152,152,0,42,42,0,2007,NA,NA,NA,NA,NA,NA,NA,NA
"221","MS","503","Gulf Port/Gulf Coast Regional CoC",274,67,207,18,14,4,7,5,2,2007,NA,NA,NA,NA,NA,NA,NA,NA
"222","MT","500","Montana Statewide CoC",1150,855,295,517,457,60,166,150,16,2007,NA,NA,NA,NA,NA,NA,NA,NA
"223","NC","500","Winston-Salem/Forsyth County CoC",503,479,24,137,137,0,47,47,0,2007,NA,NA,NA,NA,NA,NA,NA,NA
"224","NC","501","Asheville/Buncombe County CoC",635,448,187,93,93,0,34,34,0,2007,NA,NA,NA,NA,NA,NA,NA,NA
"225","NC","502","Durham City & County CoC",539,502,37,103,103,0,31,31,0,2007,NA,NA,NA,NA,NA,NA,NA,NA
"226","NC","503","North Carolina Balance of State CoC",2610,1552,1058,1174,714,460,346,221,125,2007,NA,NA,NA,NA,NA,NA,NA,NA
"227","NC","504","Greensboro, High Point CoC",1182,980,202,304,288,16,101,96,5,2007,NA,NA,NA,NA,NA,NA,NA,NA
"228","NC","505","Charlotte/Mecklenberg CoC",1976,1648,328,412,409,3,142,141,1,2007,NA,NA,NA,NA,NA,NA,NA,NA
"229","NC","506","Wilmington/Brunswick, New Hanover, Pender Counties CoC",628,419,209,169,79,90,70,28,42,2007,NA,NA,NA,NA,NA,NA,NA,NA
"230","NC","507","Raleigh/Wake County CoC",1043,973,70,338,338,0,110,110,0,2007,NA,NA,NA,NA,NA,NA,NA,NA
"231","NC","509","Gastonia/Cleveland, Gaston, Lincoln Counties CoC",652,214,438,84,63,21,32,24,8,2007,NA,NA,NA,NA,NA,NA,NA,NA
"232","NC","511","Fayetteville/Cumberland County CoC",757,313,444,312,145,167,103,44,59,2007,NA,NA,NA,NA,NA,NA,NA,NA
"233","NC","513","Chapel Hill/Orange County CoC",208,183,25,60,56,4,23,22,1,2007,NA,NA,NA,NA,NA,NA,NA,NA
"234","NC","516","Northwest North Carolina CoC",1069,168,901,225,61,164,160,24,136,2007,NA,NA,NA,NA,NA,NA,NA,NA
"235","ND","500","North Dakota Statewide CoC",636,577,59,233,198,35,70,61,9,2007,NA,NA,NA,NA,NA,NA,NA,NA
"236","NE","500","Nebraska Balance of State CoC",695,537,158,397,308,89,142,118,24,2007,NA,NA,NA,NA,NA,NA,NA,NA
"237","NE","501","Omaha, Council Bluffs CoC",1870,1632,238,532,532,0,210,210,0,2007,NA,NA,NA,NA,NA,NA,NA,NA
"238","NE","502","Lincoln CoC",966,838,128,430,430,0,163,163,0,2007,NA,NA,NA,NA,NA,NA,NA,NA
"239","NH","500","New Hampshire Balance of State CoC",1300,769,531,635,372,263,248,149,99,2007,NA,NA,NA,NA,NA,NA,NA,NA
"240","NH","501","Manchester CoC",504,307,197,159,135,24,62,47,15,2007,NA,NA,NA,NA,NA,NA,NA,NA
"241","NH","502","Nashua/Hillsborough County CoC",444,197,247,199,115,84,70,40,30,2007,NA,NA,NA,NA,NA,NA,NA,NA
"242","NJ","500","Atlantic City & County CoC",514,425,89,156,153,3,52,51,1,2007,NA,NA,NA,NA,NA,NA,NA,NA
"243","NJ","501","Bergen County CoC",1392,1210,182,769,703,66,313,288,25,2007,NA,NA,NA,NA,NA,NA,NA,NA
"244","NJ","502","Burlington County CoC",896,780,116,286,272,14,152,145,7,2007,NA,NA,NA,NA,NA,NA,NA,NA
"245","NJ","503","Camden City & County/Gloucester, Cape May, Cumberland Counties CoC",1433,1124,309,428,385,43,194,180,14,2007,NA,NA,NA,NA,NA,NA,NA,NA
"246","NJ","504","Newark/Essex County CoC",2326,1906,420,917,826,91,369,333,36,2007,NA,NA,NA,NA,NA,NA,NA,NA
"247","NJ","506","Jersey City, Bayonne/Hudson County CoC",2842,2678,164,1951,1951,0,730,730,0,2007,NA,NA,NA,NA,NA,NA,NA,NA
"248","NJ","507","New Brunswick/Middlesex County CoC",996,728,268,274,250,24,98,93,5,2007,NA,NA,NA,NA,NA,NA,NA,NA
"249","NJ","508","Monmouth County CoC",830,757,73,388,376,12,175,170,5,2007,NA,NA,NA,NA,NA,NA,NA,NA
"250","NJ","509","Morris County CoC",292,229,63,140,140,0,56,56,0,2007,NA,NA,NA,NA,NA,NA,NA,NA
"251","NJ","510","Lakewood Township/Ocean County CoC",424,381,43,167,167,0,75,75,0,2007,NA,NA,NA,NA,NA,NA,NA,NA
"252","NJ","511","Paterson/Passaic County CoC",1062,831,231,684,556,128,187,153,34,2007,NA,NA,NA,NA,NA,NA,NA,NA
"253","NJ","512","Salem County CoC",465,454,11,214,214,0,84,84,0,2007,NA,NA,NA,NA,NA,NA,NA,NA
"254","NJ","513","Somerset County CoC",366,343,23,147,147,0,57,57,0,2007,NA,NA,NA,NA,NA,NA,NA,NA
"255","NJ","514","Trenton/Mercer County CoC",1598,1242,356,758,613,145,271,223,48,2007,NA,NA,NA,NA,NA,NA,NA,NA
"256","NJ","515","Elizabeth/Union County CoC",1188,1072,116,765,753,12,272,270,2,2007,NA,NA,NA,NA,NA,NA,NA,NA
"257","NJ","516","Warren, Sussex, Hunterdon Counties CoC",690,676,14,298,296,2,116,115,1,2007,NA,NA,NA,NA,NA,NA,NA,NA
"258","NM","500","Albuquerque CoC",1276,989,287,455,383,72,147,124,23,2007,NA,NA,NA,NA,NA,NA,NA,NA
"259","NM","501","New Mexico Balance of State CoC",1739,759,980,699,302,397,220,102,118,2007,NA,NA,NA,NA,NA,NA,NA,NA
"260","NV","500","Las Vegas/Clark County CoC",7533,3844,3689,1909,942,967,606,285,321,2007,NA,NA,NA,NA,NA,NA,NA,NA
"261","NV","501","Reno, Sparks/Washoe County CoC",863,765,98,121,118,3,40,39,1,2007,NA,NA,NA,NA,NA,NA,NA,NA
"262","NV","502","Nevada Balance of State CoC",246,209,37,135,119,16,54,49,5,2007,NA,NA,NA,NA,NA,NA,NA,NA
"263","NY","500","Rochester, Irondequoit, Greece/Monroe County CoC",612,602,10,275,275,0,87,87,0,2007,NA,NA,NA,NA,NA,NA,NA,NA
"264","NY","501","Elmira/Steuben, Allegany, Livingston, Chemung, Schuyler Counties CoC",175,174,1,36,36,0,11,11,0,2007,NA,NA,NA,NA,NA,NA,NA,NA
"265","NY","503","Albany City & County CoC",619,539,80,223,208,15,68,64,4,2007,NA,NA,NA,NA,NA,NA,NA,NA
"266","NY","504","Cattaragus County CoC",142,104,38,47,37,10,13,11,2,2007,NA,NA,NA,NA,NA,NA,NA,NA
"267","NY","505","Syracuse, Auburn/Onondaga, Oswego, Cayuga Counties CoC",795,762,33,161,145,16,61,56,5,2007,NA,NA,NA,NA,NA,NA,NA,NA
"268","NY","507","Schenectady City & County CoC",288,209,79,132,117,15,51,46,5,2007,NA,NA,NA,NA,NA,NA,NA,NA
"269","NY","508","Buffalo, Niagara Falls/Erie, Niagara, Orleans, Genesee, Wyoming Counties CoC",1377,1203,174,448,448,0,131,131,0,2007,NA,NA,NA,NA,NA,NA,NA,NA
"270","NY","510","Ithaca/Tompkins County CoC",78,62,16,32,32,0,10,10,0,2007,NA,NA,NA,NA,NA,NA,NA,NA
"271","NY","511","Binghamton, Union Town/Broome, Otsego, Chenango, Delaware, Cortland, Tioga Count",243,203,40,31,26,5,11,9,2,2007,NA,NA,NA,NA,NA,NA,NA,NA
"272","NY","512","Troy/Rensselaer County CoC",212,166,46,133,125,8,50,47,3,2007,NA,NA,NA,NA,NA,NA,NA,NA
"273","NY","513","Wayne, Ontario, Seneca, Yates Counties CoC",98,98,0,51,51,0,16,16,0,2007,NA,NA,NA,NA,NA,NA,NA,NA
"274","NY","514","Jamestown, Dunkirk/Chautauqua County CoC",75,67,8,49,49,0,23,23,0,2007,NA,NA,NA,NA,NA,NA,NA,NA
"275","NY","515","Cortland County CoC",NA,NA,NA,NA,NA,NA,NA,NA,NA,2007,NA,NA,NA,NA,NA,NA,NA,NA
"276","NY","516","Clinton County CoC",53,48,5,3,3,0,1,1,0,2007,NA,NA,NA,NA,NA,NA,NA,NA
"277","NY","518","Utica, Rome/Oneida, Madison Counties CoC",334,318,16,141,141,0,44,44,0,2007,NA,NA,NA,NA,NA,NA,NA,NA
"278","NY","519","Columbia, Greene Counties CoC",325,311,14,185,183,2,70,69,1,2007,NA,NA,NA,NA,NA,NA,NA,NA
"279","NY","520","Franklin, Essex Counties CoC",28,27,1,8,8,0,4,4,0,2007,NA,NA,NA,NA,NA,NA,NA,NA
"280","NY","523","Glens Falls, Saratoga Springs/Saratoga, Washington, Warren, Hamilton Counties Co",255,146,109,73,60,13,24,20,4,2007,NA,NA,NA,NA,NA,NA,NA,NA
"281","NY","600","New York City CoC",50372,46617,3755,29015,29015,0,9430,9430,0,2007,NA,NA,NA,NA,NA,NA,NA,NA
"282","NY","601","Poughkeepsie/Dutchess County CoC",547,463,84,259,230,29,93,83,10,2007,NA,NA,NA,NA,NA,NA,NA,NA
"283","NY","602","Newburgh, Middletown/Orange County CoC",414,227,187,113,109,4,31,30,1,2007,NA,NA,NA,NA,NA,NA,NA,NA
"284","NY","603","Nassau, Suffolk Counties CoC",2509,2351,158,1720,1720,0,534,534,0,2007,NA,NA,NA,NA,NA,NA,NA,NA
"285","NY","604","Yonkers, Mount Vernon/Westchester County CoC",1829,1693,136,1139,1139,0,365,365,0,2007,NA,NA,NA,NA,NA,NA,NA,NA
"286","NY","606","Rockland County CoC",488,435,53,42,42,0,19,19,0,2007,NA,NA,NA,NA,NA,NA,NA,NA
"287","NY","607","Sullivan County CoC",343,267,76,117,108,9,57,54,3,2007,NA,NA,NA,NA,NA,NA,NA,NA
"288","NY","608","Kingston/Ulster County CoC",359,158,201,112,67,45,41,28,13,2007,NA,NA,NA,NA,NA,NA,NA,NA
"289","NY","609","Putnam County CoC",31,31,0,0,0,0,0,0,0,2007,NA,NA,NA,NA,NA,NA,NA,NA
"290","OH","500","Cincinnati/Hamilton County CoC",1046,987,59,326,326,0,95,95,0,2007,NA,NA,NA,NA,NA,NA,NA,NA
"291","OH","501","Toledo/Lucas County CoC",745,631,114,321,312,9,133,129,4,2007,NA,NA,NA,NA,NA,NA,NA,NA
"292","OH","502","Cleveland/Cuyahoga County CoC",2185,2001,184,499,484,15,166,161,5,2007,NA,NA,NA,NA,NA,NA,NA,NA
"293","OH","503","Columbus/Franklin County CoC",1373,1259,114,432,432,0,135,135,0,2007,NA,NA,NA,NA,NA,NA,NA,NA
"294","OH","504","Youngstown/Mahoning County CoC",249,232,17,128,128,0,44,44,0,2007,NA,NA,NA,NA,NA,NA,NA,NA
"295","OH","505","Dayton, Kettering/Montgomery County CoC",785,719,66,281,281,0,101,101,0,2007,NA,NA,NA,NA,NA,NA,NA,NA
"296","OH","506","Akron, Barberton/Summit County CoC",824,632,192,249,218,31,80,73,7,2007,NA,NA,NA,NA,NA,NA,NA,NA
"297","OH","507","Ohio Balance of State CoC",3521,2498,1023,1905,1374,531,788,580,208,2007,NA,NA,NA,NA,NA,NA,NA,NA
"298","OH","508","Canton, Massillon, Alliance/Stark County CoC",536,421,115,253,233,20,80,74,6,2007,NA,NA,NA,NA,NA,NA,NA,NA
"299","OK","500","North Central Oklahoma CoC",212,173,39,70,61,9,22,20,2,2007,NA,NA,NA,NA,NA,NA,NA,NA
"300","OK","501","Tulsa City & County CoC",666,594,72,188,171,17,57,52,5,2007,NA,NA,NA,NA,NA,NA,NA,NA
"301","OK","502","Oklahoma City CoC",1734,1278,456,313,285,28,118,107,11,2007,NA,NA,NA,NA,NA,NA,NA,NA
"302","OK","503","Oklahoma Balance of State CoC",231,149,82,77,65,12,27,24,3,2007,NA,NA,NA,NA,NA,NA,NA,NA
"303","OK","504","Norman/Cleveland County CoC",594,322,272,265,96,169,86,21,65,2007,NA,NA,NA,NA,NA,NA,NA,NA
"304","OK","505","Northeast Oklahoma CoC",305,150,155,143,41,102,44,14,30,2007,NA,NA,NA,NA,NA,NA,NA,NA
"305","OK","506","Southwest Oklahoma Regional CoC",250,226,24,65,65,0,22,22,0,2007,NA,NA,NA,NA,NA,NA,NA,NA
"306","OK","507","Southeastern Oklahoma Regional CoC",229,197,32,118,104,14,57,50,7,2007,NA,NA,NA,NA,NA,NA,NA,NA
"307","OR","500","Eugene, Springfield/Lane County CoC",2332,1560,772,1037,744,293,312,246,66,2007,NA,NA,NA,NA,NA,NA,NA,NA
"308","OR","501","Portland, Gresham/Multnomah County CoC",3918,2284,1634,913,842,71,317,287,30,2007,NA,NA,NA,NA,NA,NA,NA,NA
"309","OR","502","Medford, Ashland/Jackson County CoC",624,351,273,235,187,48,72,57,15,2007,NA,NA,NA,NA,NA,NA,NA,NA
"310","OR","503","Central Oregon CoC",2029,315,1714,1302,179,1123,401,63,338,2007,NA,NA,NA,NA,NA,NA,NA,NA
"311","OR","505","Oregon Balance of State CoC",6431,3385,3046,3529,1952,1577,1123,626,497,2007,NA,NA,NA,NA,NA,NA,NA,NA
"312","OR","506","Hillsboro, Beaverton/Washington County CoC",680,268,412,285,180,105,114,83,31,2007,NA,NA,NA,NA,NA,NA,NA,NA
"313","OR","507","Clackamas County CoC",1576,166,1410,418,125,293,124,44,80,2007,NA,NA,NA,NA,NA,NA,NA,NA
"314","PA","500","Philadelphia CoC",7640,7193,447,3771,3771,0,1220,1220,0,2007,NA,NA,NA,NA,NA,NA,NA,NA
"315","PA","501","Harrisburg/Dauphin County CoC",412,358,54,148,142,6,50,48,2,2007,NA,NA,NA,NA,NA,NA,NA,NA
"316","PA","502","Upper Darby, Chester, Haverford/Delaware County CoC",696,659,37,479,479,0,143,143,0,2007,NA,NA,NA,NA,NA,NA,NA,NA
"317","PA","503","Wilkes-Barre, Hazleton/Luzerne County CoC",188,165,23,70,70,0,28,28,0,2007,NA,NA,NA,NA,NA,NA,NA,NA
"318","PA","504","Lower Merion, Norristown, Abington/Montgomery County CoC",526,407,119,318,243,75,96,78,18,2007,NA,NA,NA,NA,NA,NA,NA,NA
"319","PA","505","Chester County CoC",387,300,87,209,201,8,75,73,2,2007,NA,NA,NA,NA,NA,NA,NA,NA
"320","PA","506","Reading/Berks County CoC",739,681,58,442,442,0,152,152,0,2007,NA,NA,NA,NA,NA,NA,NA,NA
"321","PA","508","Scranton/Lackawanna County CoC",222,202,20,131,123,8,47,45,2,2007,NA,NA,NA,NA,NA,NA,NA,NA
"322","PA","509","Eastern Pennsylvania CoC",1662,1549,113,913,893,20,303,297,6,2007,NA,NA,NA,NA,NA,NA,NA,NA
"323","PA","510","Lancaster City & County CoC",589,549,40,264,260,4,98,97,1,2007,NA,NA,NA,NA,NA,NA,NA,NA
"324","PA","511","Bristol, Bensalem/Bucks County CoC",262,254,8,119,119,0,39,39,0,2007,NA,NA,NA,NA,NA,NA,NA,NA
"325","PA","600","Pittsburgh, McKeesport, Penn Hills/Allegheny County CoC",1380,1132,248,479,477,2,177,176,1,2007,NA,NA,NA,NA,NA,NA,NA,NA
"326","PA","601","Western Pennsylvania CoC",911,844,67,452,440,12,157,152,5,2007,NA,NA,NA,NA,NA,NA,NA,NA
"327","PA","603","Beaver County CoC",213,131,82,24,21,3,8,7,1,2007,NA,NA,NA,NA,NA,NA,NA,NA
"328","PA","605","Erie City & County CoC",393,317,76,172,128,44,58,42,16,2007,NA,NA,NA,NA,NA,NA,NA,NA
"329","RI","500","Rhode Island Statewide CoC",1372,1323,49,729,724,5,214,212,2,2007,NA,NA,NA,NA,NA,NA,NA,NA
"330","SC","500","Charleston/Low Country CoC",539,482,57,107,101,6,40,37,3,2007,NA,NA,NA,NA,NA,NA,NA,NA
"331","SC","501","Greenville, Anderson, Spartanburg/Upstate CoC",1606,1100,506,517,392,125,157,132,25,2007,NA,NA,NA,NA,NA,NA,NA,NA
"332","SC","502","Columbia/Midlands CoC",1569,946,623,291,226,65,97,78,19,2007,NA,NA,NA,NA,NA,NA,NA,NA
"333","SC","503","Myrtle Beach, Sumter City & County CoC",1946,558,1388,974,337,637,164,79,85,2007,NA,NA,NA,NA,NA,NA,NA,NA
"334","SD","500","South Dakota Statewide CoC",579,538,41,311,303,8,108,104,4,2007,NA,NA,NA,NA,NA,NA,NA,NA
"335","TN","500","Chattanooga/Southeast Tennessee CoC",1064,307,757,87,72,15,37,25,12,2007,NA,NA,NA,NA,NA,NA,NA,NA
"336","TN","501","Memphis/Shelby County CoC",1814,1744,70,633,633,0,198,198,0,2007,NA,NA,NA,NA,NA,NA,NA,NA
"337","TN","502","Knoxville/Knox County CoC",956,830,126,162,154,8,55,52,3,2007,NA,NA,NA,NA,NA,NA,NA,NA
"338","TN","503","Central Tennessee CoC",360,281,79,109,81,28,23,16,7,2007,NA,NA,NA,NA,NA,NA,NA,NA
"339","TN","504","Nashville-Davidson County CoC",2156,1766,390,160,152,8,67,65,2,2007,NA,NA,NA,NA,NA,NA,NA,NA
"340","TN","506","Upper Cumberland CoC",704,196,508,371,80,291,133,29,104,2007,NA,NA,NA,NA,NA,NA,NA,NA
"341","TN","507","Jackson/West Tennessee CoC",2255,254,2001,560,45,515,227,21,206,2007,NA,NA,NA,NA,NA,NA,NA,NA
"342","TN","509","Appalachian Regional CoC",559,345,214,81,73,8,26,23,3,2007,NA,NA,NA,NA,NA,NA,NA,NA
"343","TN","510","Murfreesboro/Rutherford County CoC",438,290,148,63,46,17,16,14,2,2007,NA,NA,NA,NA,NA,NA,NA,NA
"344","TN","512","Morristown/Blount, Sevier, Campbell, Cocke Counties CoC",904,433,471,522,387,135,173,117,56,2007,NA,NA,NA,NA,NA,NA,NA,NA
"345","TX","500","San Antonio/Bexar County CoC",2247,1798,449,872,853,19,277,272,5,2007,NA,NA,NA,NA,NA,NA,NA,NA
"346","TX","503","Austin/Travis County CoC",5281,1395,3886,2165,622,1543,616,175,441,2007,NA,NA,NA,NA,NA,NA,NA,NA
"347","TX","600","Dallas City & County, Irving CoC",3408,3041,367,1362,1358,4,438,437,1,2007,NA,NA,NA,NA,NA,NA,NA,NA
"348","TX","601","Fort Worth, Arlington/Tarrant County CoC",2876,2675,201,1326,1326,0,422,422,0,2007,NA,NA,NA,NA,NA,NA,NA,NA
"349","TX","603","El Paso City & County CoC",1241,968,273,437,437,0,133,133,0,2007,NA,NA,NA,NA,NA,NA,NA,NA
"350","TX","604","Waco/McLennan County CoC",431,259,172,110,83,27,38,32,6,2007,NA,NA,NA,NA,NA,NA,NA,NA
"351","TX","607","Texas Balance of State CoC",12958,6998,5960,4552,2613,1939,1131,601,530,2007,NA,NA,NA,NA,NA,NA,NA,NA
"352","TX","611","Amarillo CoC",431,298,133,173,162,11,68,64,4,2007,NA,NA,NA,NA,NA,NA,NA,NA
"353","TX","624","Wichita Falls/Wise, Palo Pinto, Wichita, Archer Counties CoC",263,214,49,40,40,0,14,14,0,2007,NA,NA,NA,NA,NA,NA,NA,NA
"354","TX","700","Houston, Pasadena, Conroe/Harris, Ft. Bend, Montgomery, Counties CoC",10363,5017,5346,2309,2157,152,668,623,45,2007,NA,NA,NA,NA,NA,NA,NA,NA
"355","TX","701","Bryan, College Station/Brazos Valley CoC",289,219,70,136,112,24,34,28,6,2007,NA,NA,NA,NA,NA,NA,NA,NA
"356","UT","500","Salt Lake City & County CoC",2079,1881,198,689,689,0,261,261,0,2007,NA,NA,NA,NA,NA,NA,NA,NA
"357","UT","503","Utah Balance of State CoC",716,630,86,246,246,0,81,81,0,2007,NA,NA,NA,NA,NA,NA,NA,NA
"358","UT","504","Provo/Mountainland CoC",216,187,29,131,131,0,53,53,0,2007,NA,NA,NA,NA,NA,NA,NA,NA
"359","VA","500","Richmond/Henrico, Chesterfield, Hanover Counties CoC",1158,1014,144,241,239,2,102,101,1,2007,NA,NA,NA,NA,NA,NA,NA,NA
"360","VA","501","Norfolk/Chesapeake, Suffolk, Isle of Wight, Southampton Counties CoC",699,543,156,186,170,16,76,61,15,2007,NA,NA,NA,NA,NA,NA,NA,NA
"361","VA","502","Roanoke City & County, Salem CoC",566,528,38,81,81,0,31,31,0,2007,NA,NA,NA,NA,NA,NA,NA,NA
"362","VA","503","Virginia Beach CoC",476,430,46,298,285,13,94,90,4,2007,NA,NA,NA,NA,NA,NA,NA,NA
"363","VA","504","Charlottesville CoC",265,237,28,69,69,0,22,22,0,2007,NA,NA,NA,NA,NA,NA,NA,NA
"364","VA","505","Newport News, Hampton/Virginia Peninsula CoC",908,569,339,346,210,136,100,63,37,2007,NA,NA,NA,NA,NA,NA,NA,NA
"365","VA","507","Portsmouth CoC",217,165,52,80,80,0,30,30,0,2007,NA,NA,NA,NA,NA,NA,NA,NA
"366","VA","508","Lynchburg CoC",289,98,191,65,37,28,27,15,12,2007,NA,NA,NA,NA,NA,NA,NA,NA
"367","VA","513","Harrisburg, Winchester/Western Virginia CoC",382,326,56,187,174,13,61,53,8,2007,NA,NA,NA,NA,NA,NA,NA,NA
"368","VA","514","Fredericksburg/Spotsylvania, Stafford Counties CoC",561,515,46,473,471,2,181,180,1,2007,NA,NA,NA,NA,NA,NA,NA,NA
"369","VA","521","Virginia Balance of State CoC",970,707,263,465,366,99,170,137,33,2007,NA,NA,NA,NA,NA,NA,NA,NA
"370","VA","600","Arlington County CoC",462,243,219,137,137,0,42,42,0,2007,NA,NA,NA,NA,NA,NA,NA,NA
"371","VA","601","Fairfax County CoC",1593,1439,154,946,946,0,270,270,0,2007,NA,NA,NA,NA,NA,NA,NA,NA
"372","VA","602","Loudoun County CoC",211,114,97,130,101,29,38,30,8,2007,NA,NA,NA,NA,NA,NA,NA,NA
"373","VA","603","Alexandria CoC",375,283,92,145,145,0,48,48,0,2007,NA,NA,NA,NA,NA,NA,NA,NA
"374","VA","604","Prince William County CoC",614,356,258,374,264,110,118,82,36,2007,NA,NA,NA,NA,NA,NA,NA,NA
"375","VT","500","Vermont Balance of State CoC",796,516,280,311,222,89,111,81,30,2007,NA,NA,NA,NA,NA,NA,NA,NA
"376","VT","501","Burlington/Chittenden County CoC",239,204,35,125,118,7,43,40,3,2007,NA,NA,NA,NA,NA,NA,NA,NA
"377","WA","500","Seattle/King County CoC",7902,5680,2222,2795,2729,66,886,872,14,2007,NA,NA,NA,NA,NA,NA,NA,NA
"378","WA","501","Washington Balance of State CoC",7679,5509,2170,3864,3158,706,1423,1179,244,2007,NA,NA,NA,NA,NA,NA,NA,NA
"379","WA","502","Spokane City & County CoC",1357,1012,345,595,466,129,218,167,51,2007,NA,NA,NA,NA,NA,NA,NA,NA
"380","WA","503","Tacoma, Lakewood/Pierce County CoC",1596,1342,254,936,907,29,299,289,10,2007,NA,NA,NA,NA,NA,NA,NA,NA
"381","WA","504","Everett/Snohomish County CoC",3453,2150,1303,1257,936,321,676,543,133,2007,NA,NA,NA,NA,NA,NA,NA,NA
"382","WA","508","Vancouver/Clark County CoC",1392,1164,228,643,548,95,220,188,32,2007,NA,NA,NA,NA,NA,NA,NA,NA
"383","WI","500","Wisconsin Balance of State CoC",3105,2817,288,2061,1951,110,715,676,39,2007,NA,NA,NA,NA,NA,NA,NA,NA
"384","WI","501","Milwaukee City & County CoC",1470,1295,175,701,612,89,239,210,29,2007,NA,NA,NA,NA,NA,NA,NA,NA
"385","WI","502","Racine City & County CoC",256,250,6,118,112,6,42,41,1,2007,NA,NA,NA,NA,NA,NA,NA,NA
"386","WI","503","Madison/Dane County CoC",817,723,94,365,339,26,112,106,6,2007,NA,NA,NA,NA,NA,NA,NA,NA
"387","WV","500","Wheeling, Weirton Area CoC",118,96,22,14,11,3,6,5,1,2007,NA,NA,NA,NA,NA,NA,NA,NA
"388","WV","501","Huntington/Cabell, Wayne Counties CoC",331,273,58,96,96,0,33,33,0,2007,NA,NA,NA,NA,NA,NA,NA,NA
"389","WV","503","Charleston/Kanawha, Putnam, Boone, Clay Counties CoC",325,263,62,63,63,0,28,28,0,2007,NA,NA,NA,NA,NA,NA,NA,NA
"390","WV","508","West Virginia Balance of State CoC",1635,1515,120,321,253,68,130,104,26,2007,NA,NA,NA,NA,NA,NA,NA,NA
"391","WY","500","Wyoming Statewide CoC",537,397,140,206,140,66,91,51,40,2007,NA,NA,NA,NA,NA,NA,NA,NA
"392",NA,NA,"Total",647258,391401,255857,234558,178328,56230,78535,60814,17721,2007,NA,NA,NA,NA,NA,NA,NA,NA
"393","AK","500","Anchorage CoC",1023,921,102,328,325,3,84,83,1,2008,NA,NA,NA,NA,NA,NA,NA,NA
"394","AK","501","Alaska Balance of State CoC",623,531,92,251,215,36,88,75,13,2008,NA,NA,NA,NA,NA,NA,NA,NA
"395","AL","500","Birmingham/Jefferson, St. Clair, Shelby Counties CoC",2104,1240,864,575,407,168,228,153,75,2008,NA,NA,NA,NA,NA,NA,NA,NA
"396","AL","501","Mobile City & County/Baldwin County CoC",524,341,183,174,161,13,62,57,5,2008,NA,NA,NA,NA,NA,NA,NA,NA
"397","AL","502","Florence/Northwest Alabama CoC",249,178,71,76,50,26,23,15,8,2008,NA,NA,NA,NA,NA,NA,NA,NA
"398","AL","503","Huntsville/North Alabama CoC",714,637,77,118,118,0,47,47,0,2008,NA,NA,NA,NA,NA,NA,NA,NA
"399","AL","504","Montgomery City & County CoC",444,327,117,74,65,9,26,23,3,2008,NA,NA,NA,NA,NA,NA,NA,NA
"400","AL","505","Gadsden/Northeast Alabama CoC",298,262,36,92,81,11,25,22,3,2008,NA,NA,NA,NA,NA,NA,NA,NA
"401","AL","506","Tuscaloosa City & County CoC",196,192,4,26,26,0,11,11,0,2008,NA,NA,NA,NA,NA,NA,NA,NA
"402","AL","507","Alabama Balance of State CoC",858,666,192,166,132,34,61,48,13,2008,NA,NA,NA,NA,NA,NA,NA,NA
"403","AR","500","Little Rock/Central Arkansas CoC",1811,1176,635,190,178,12,61,58,3,2008,NA,NA,NA,NA,NA,NA,NA,NA
"404","AR","501","Fayetteville/Northwest Arkansas CoC",313,273,40,78,70,8,47,43,4,2008,NA,NA,NA,NA,NA,NA,NA,NA
"405","AR","502","Conway/Arkansas River Valley",163,59,104,76,40,36,26,17,9,2008,NA,NA,NA,NA,NA,NA,NA,NA
"406","AR","504","Delta Hills CoC",817,374,443,191,27,164,127,17,110,2008,NA,NA,NA,NA,NA,NA,NA,NA
"407","AR","505","Southeast Arkansas CoC",130,120,10,95,88,7,24,22,2,2008,NA,NA,NA,NA,NA,NA,NA,NA
"408","AR","506","Johnson, Pope, Yell Counties",21,18,3,0,0,0,0,0,0,2008,NA,NA,NA,NA,NA,NA,NA,NA
"409","AZ","500","Arizona Balance of State CoC",2940,956,1984,778,497,281,280,164,116,2008,NA,NA,NA,NA,NA,NA,NA,NA
"410","AZ","501","Tucson/Pima County CoC",2359,1251,1108,779,643,136,286,220,66,2008,NA,NA,NA,NA,NA,NA,NA,NA
"411","AZ","502","Phoenix, Mesa/Maricopa County CoC",7189,4763,2426,2503,2454,49,711,701,10,2008,NA,NA,NA,NA,NA,NA,NA,NA
"412","CA","500","San Jose/Santa Clara City & County CoC",7202,2101,5101,1257,996,261,366,297,69,2008,NA,NA,NA,NA,NA,NA,NA,NA
"413","CA","501","San Francisco CoC",5171,2400,2771,532,512,20,194,186,8,2008,NA,NA,NA,NA,NA,NA,NA,NA
"414","CA","502","Oakland, Berkeley/Alameda County CoC",4838,2342,2496,1812,1085,727,653,369,284,2008,NA,NA,NA,NA,NA,NA,NA,NA
"415","CA","503","Sacramento City & County CoC",2615,1349,1266,442,409,33,161,149,12,2008,NA,NA,NA,NA,NA,NA,NA,NA
"416","CA","504","Santa Rosa, Petaluma/Sonoma County CoC",1314,782,532,426,375,51,149,126,23,2008,NA,NA,NA,NA,NA,NA,NA,NA
"417","CA","505","Richmond/Contra Costa County CoC",4062,903,3159,1170,571,599,344,198,146,2008,NA,NA,NA,NA,NA,NA,NA,NA
"418","CA","506","Salinas/Monterey, San Benito Counties CoC",1402,509,893,253,247,6,79,77,2,2008,NA,NA,NA,NA,NA,NA,NA,NA
"419","CA","507","Marin County CoC",1002,602,400,156,137,19,52,43,9,2008,NA,NA,NA,NA,NA,NA,NA,NA
"420","CA","508","Watsonville/Santa Cruz City & County CoC",2789,486,2303,381,225,156,127,74,53,2008,NA,NA,NA,NA,NA,NA,NA,NA
"421","CA","509","Mendocino County CoC",1423,285,1138,230,120,110,152,42,110,2008,NA,NA,NA,NA,NA,NA,NA,NA
"422","CA","510","Turlock, Modesto/Stanislaus County CoC",1593,634,959,592,352,240,198,117,81,2008,NA,NA,NA,NA,NA,NA,NA,NA
"423","CA","511","Stockton/San Joaquin County CoC",2354,2051,303,822,759,63,264,225,39,2008,NA,NA,NA,NA,NA,NA,NA,NA
"424","CA","512","Daly/San Mateo County CoC",1798,704,1094,410,394,16,126,122,4,2008,NA,NA,NA,NA,NA,NA,NA,NA
"425","CA","513","Visalia/Kings, Tulare Counties CoC",1040,189,851,572,88,484,208,25,183,2008,NA,NA,NA,NA,NA,NA,NA,NA
"426","CA","514","Fresno City & County/Madera County CoC",3507,1951,1556,1541,666,875,467,280,187,2008,NA,NA,NA,NA,NA,NA,NA,NA
"427","CA","515","Roseville, Rocklin/Placer, Nevada Counties CoC",587,450,137,219,206,13,60,56,4,2008,NA,NA,NA,NA,NA,NA,NA,NA
"428","CA","516","Redding/Shasta, Siskiyou, Lassen, Plumas, Del Norte, Modoc, Sierra Counties CoC",263,201,62,77,70,7,31,28,3,2008,NA,NA,NA,NA,NA,NA,NA,NA
"429","CA","517","Napa City & County CoC",365,219,146,129,105,24,32,24,8,2008,NA,NA,NA,NA,NA,NA,NA,NA
"430","CA","518","Vallejo/Solano County CoC",1956,457,1499,1138,232,906,475,113,362,2008,NA,NA,NA,NA,NA,NA,NA,NA
"431","CA","519","Chico, Paradise/Butte County CoC",592,322,270,151,121,30,44,36,8,2008,NA,NA,NA,NA,NA,NA,NA,NA
"432","CA","520","Merced City & County CoC",2455,135,2320,383,35,348,111,10,101,2008,NA,NA,NA,NA,NA,NA,NA,NA
"433","CA","521","Davis, Woodland/Yolo County CoC",414,228,186,122,118,4,37,36,1,2008,NA,NA,NA,NA,NA,NA,NA,NA
"434","CA","522","Humboldt County CoC",907,322,585,541,183,358,146,57,89,2008,NA,NA,NA,NA,NA,NA,NA,NA
"435","CA","523","Colusa, Glenn, Trinity Counties CoC",193,0,193,62,0,62,22,0,22,2008,NA,NA,NA,NA,NA,NA,NA,NA
"436","CA","524","Yuba City & County/Sutter County CoC",594,483,111,347,307,40,90,80,10,2008,NA,NA,NA,NA,NA,NA,NA,NA
"437","CA","525","El Dorado County CoC",150,75,75,22,22,0,7,7,0,2008,NA,NA,NA,NA,NA,NA,NA,NA
"438","CA","526","Amador, Calaveras, Mariposa, Tuolumne Counties CoC",400,79,321,148,53,95,50,19,31,2008,NA,NA,NA,NA,NA,NA,NA,NA
"439","CA","600","Los Angeles City & County CoC",47862,11442,36420,3677,3025,652,1165,909,256,2008,NA,NA,NA,NA,NA,NA,NA,NA
"440","CA","601","San Diego City and County CoC",8455,4417,4038,2460,2176,284,758,656,102,2008,NA,NA,NA,NA,NA,NA,NA,NA
"441","CA","602","Santa Ana, Anaheim/Orange County CoC",3649,2578,1071,1537,1282,255,513,439,74,2008,NA,NA,NA,NA,NA,NA,NA,NA
"442","CA","603","Santa Maria/Santa Barbara County CoC",4253,1480,2773,1041,769,272,245,178,67,2008,NA,NA,NA,NA,NA,NA,NA,NA
"443","CA","604","Bakersfield/Kern County CoC",1537,905,632,289,259,30,89,83,6,2008,NA,NA,NA,NA,NA,NA,NA,NA
"444","CA","606","Long Beach CoC",3829,1679,2150,1015,490,525,320,163,157,2008,NA,NA,NA,NA,NA,NA,NA,NA
"445","CA","607","Pasadena CoC",983,434,549,293,136,157,74,35,39,2008,NA,NA,NA,NA,NA,NA,NA,NA
"446","CA","608","Riverside City & County CoC",4508,1330,3178,1165,718,447,338,205,133,2008,NA,NA,NA,NA,NA,NA,NA,NA
"447","CA","609","San Bernardino City & County CoC",6969,1220,5749,778,611,167,237,192,45,2008,NA,NA,NA,NA,NA,NA,NA,NA
"448","CA","611","Oxnard, San Buenaventura/Ventura County CoC",1961,551,1410,781,283,498,369,92,277,2008,NA,NA,NA,NA,NA,NA,NA,NA
"449","CA","612","Glendale CoC",296,233,63,135,110,25,50,42,8,2008,NA,NA,NA,NA,NA,NA,NA,NA
"450","CA","613","Imperial County CoC",393,156,237,104,104,0,33,33,0,2008,NA,NA,NA,NA,NA,NA,NA,NA
"451","CA","614","San Luis Obispo County CoC",850,281,569,271,109,162,88,34,54,2008,NA,NA,NA,NA,NA,NA,NA,NA
"452","CO","500","Colorado Balance of State CoC",5188,1233,3955,3359,895,2464,840,224,616,2008,NA,NA,NA,NA,NA,NA,NA,NA
"453","CO","503","Metropolitan Denver CoC",8482,4951,3531,4813,2739,2074,1520,916,604,2008,NA,NA,NA,NA,NA,NA,NA,NA
"454","CO","504","Colorado Springs/El Paso County CoC",1077,693,384,315,259,56,97,75,22,2008,NA,NA,NA,NA,NA,NA,NA,NA
"455","CT","503","Bridgeport, Stamford, Norwalk/Fairfield County CoC",846,749,97,284,278,6,99,97,2,2008,NA,NA,NA,NA,NA,NA,NA,NA
"456","CT","505","Connecticut Balance of State CoC",3781,3271,510,1570,1557,13,524,519,5,2008,NA,NA,NA,NA,NA,NA,NA,NA
"457","DE","500","Delaware Statewide CoC",933,862,71,281,281,0,85,85,0,2008,NA,NA,NA,NA,NA,NA,NA,NA
"458","FL","500","Sarasota, Bradenton/Manatee, Sarasota Counties CoC",1361,530,831,318,177,141,137,59,78,2008,NA,NA,NA,NA,NA,NA,NA,NA
"459","FL","501","Tampa/Hillsborough County CoC",6483,1050,5433,2086,466,1620,837,148,689,2008,NA,NA,NA,NA,NA,NA,NA,NA
"460","FL","502","St. Petersburg, Clearwater, Largo/Pinellas County CoC",2526,1305,1221,397,394,3,151,150,1,2008,NA,NA,NA,NA,NA,NA,NA,NA
"461","FL","503","Lakeland, Winterhaven/Polk County CoC",1149,708,441,219,183,36,67,56,11,2008,NA,NA,NA,NA,NA,NA,NA,NA
"462","FL","504","Daytona Beach, Daytona/Volusia, Flagler Counties CoC",1801,576,1225,634,312,322,224,132,92,2008,NA,NA,NA,NA,NA,NA,NA,NA
"463","FL","505","Fort Walton Beach/Okaloosa, Walton Counties CoC",1763,330,1433,770,41,729,327,17,310,2008,NA,NA,NA,NA,NA,NA,NA,NA
"464","FL","506","Tallahassee/Leon County CoC",590,495,95,156,131,25,44,37,7,2008,NA,NA,NA,NA,NA,NA,NA,NA
"465","FL","507","Orlando/Orange, Osceola, Seminole Counties CoC",3734,2366,1368,1937,1310,627,646,437,209,2008,NA,NA,NA,NA,NA,NA,NA,NA
"466","FL","508","Gainesville/Alachua, Putnam Counties CoC",744,279,465,154,105,49,47,32,15,2008,NA,NA,NA,NA,NA,NA,NA,NA
"467","FL","509","Fort Pierce/St. Lucie, Indian River, Martin Counties CoC",1503,298,1205,756,238,518,285,82,203,2008,NA,NA,NA,NA,NA,NA,NA,NA
"468","FL","510","Jacksonville-Duval, Clay Counties CoC",2585,1492,1093,752,752,0,250,250,0,2008,NA,NA,NA,NA,NA,NA,NA,NA
"469","FL","511","Pensacola/Escambia, Santa Rosa Counties CoC",1028,375,653,242,129,113,142,51,91,2008,NA,NA,NA,NA,NA,NA,NA,NA
"470","FL","512","St. Johns County CoC",1238,106,1132,139,70,69,50,33,17,2008,NA,NA,NA,NA,NA,NA,NA,NA
"471","FL","513","Palm Bay, Melbourne/Brevard County CoC",1899,502,1397,367,201,166,115,59,56,2008,NA,NA,NA,NA,NA,NA,NA,NA
"472","FL","514","Ocala/Marion County CoC",480,312,168,132,132,0,45,45,0,2008,NA,NA,NA,NA,NA,NA,NA,NA
"473","FL","515","Panama City/Bay, Jackson Counties CoC",313,211,102,44,44,0,12,12,0,2008,NA,NA,NA,NA,NA,NA,NA,NA
"474","FL","517","Hendry, Hardee, Highlands Counties CoC",2968,101,2867,1849,38,1811,834,12,822,2008,NA,NA,NA,NA,NA,NA,NA,NA
"475","FL","518","Columbia, Hamilton, Lafayette, Suwannee Counties CoC",282,92,190,102,38,64,21,11,10,2008,NA,NA,NA,NA,NA,NA,NA,NA
"476","FL","519","Pasco County CoC",4074,1500,2574,2896,1068,1828,1158,427,731,2008,NA,NA,NA,NA,NA,NA,NA,NA
"477","FL","520","Citrus, Hernando, Lake, Sumter Counties CoC",1104,216,888,518,49,469,109,16,93,2008,NA,NA,NA,NA,NA,NA,NA,NA
"478","FL","600","Miami-Dade County CoC",4574,3227,1347,1222,1220,2,328,327,1,2008,NA,NA,NA,NA,NA,NA,NA,NA
"479","FL","601","Ft Lauderdale/Broward County CoC",3154,2453,701,703,639,64,178,155,23,2008,NA,NA,NA,NA,NA,NA,NA,NA
"480","FL","602","Punta Gorda/Charlotte County CoC",730,450,280,95,88,7,46,44,2,2008,NA,NA,NA,NA,NA,NA,NA,NA
"481","FL","603","Ft Myers, Cape Coral/Lee County CoC",899,386,513,52,38,14,20,15,5,2008,NA,NA,NA,NA,NA,NA,NA,NA
"482","FL","604","Monroe County CoC",1121,477,644,104,67,37,37,27,10,2008,NA,NA,NA,NA,NA,NA,NA,NA
"483","FL","605","West Palm Beach/Palm Beach County CoC",1766,727,1039,464,413,51,150,133,17,2008,NA,NA,NA,NA,NA,NA,NA,NA
"484","FL","606","Naples/Collier County CoC",289,160,129,91,50,41,36,24,12,2008,NA,NA,NA,NA,NA,NA,NA,NA
"485","GA","500","Atlanta CoC",6840,4725,2115,1218,1174,44,379,365,14,2008,NA,NA,NA,NA,NA,NA,NA,NA
"486","GA","501","Georgia Balance of State CoC",9340,2267,7073,3444,1308,2136,1078,431,647,2008,NA,NA,NA,NA,NA,NA,NA,NA
"487","GA","503","Athens-Clarke County CoC",462,303,159,154,142,12,50,46,4,2008,NA,NA,NA,NA,NA,NA,NA,NA
"488","GA","504","Augusta-Richmond County CoC",528,496,32,135,131,4,48,47,1,2008,NA,NA,NA,NA,NA,NA,NA,NA
"489","GA","505","Columbus-Muscogee/Russell County CoC",618,244,374,59,59,0,23,23,0,2008,NA,NA,NA,NA,NA,NA,NA,NA
"490","GA","506","Marietta/Cobb County CoC",537,329,208,191,169,22,69,61,8,2008,NA,NA,NA,NA,NA,NA,NA,NA
"491","GA","507","Savannah/Chatham County CoC",770,501,269,166,166,0,75,75,0,2008,NA,NA,NA,NA,NA,NA,NA,NA
"492","HI","500","Hawaii Balance of State CoC",2311,746,1565,1075,409,666,296,121,175,2008,NA,NA,NA,NA,NA,NA,NA,NA
"493","HI","501","Honolulu City and County CoC",3750,1957,1793,1660,1203,457,438,323,115,2008,NA,NA,NA,NA,NA,NA,NA,NA
"494","IA","500","Sioux City/Dakota, Woodbury Counties CoC",271,260,11,144,144,0,47,47,0,2008,NA,NA,NA,NA,NA,NA,NA,NA
"495","IA","501","Iowa Balance of State CoC",1950,1824,126,1184,1148,36,385,370,15,2008,NA,NA,NA,NA,NA,NA,NA,NA
"496","IA","502","Des Moines/Polk County CoC",1125,1003,122,409,374,35,126,116,10,2008,NA,NA,NA,NA,NA,NA,NA,NA
"497","ID","500","Boise/Ada County CoC",611,553,58,191,191,0,62,62,0,2008,NA,NA,NA,NA,NA,NA,NA,NA
"498","ID","501","Idaho Balance of State CoC",853,697,156,456,402,54,166,144,22,2008,NA,NA,NA,NA,NA,NA,NA,NA
"499","IL","500","McHenry County CoC",199,195,4,77,77,0,24,24,0,2008,NA,NA,NA,NA,NA,NA,NA,NA
"500","IL","501","Rockford/Winnebago, Boone Counties CoC",575,525,50,254,249,5,91,89,2,2008,NA,NA,NA,NA,NA,NA,NA,NA
"501","IL","502","Waukegan, North Chicago/Lake County CoC",439,430,9,218,218,0,73,73,0,2008,NA,NA,NA,NA,NA,NA,NA,NA
"502","IL","503","Champaign, Urbana, Rantoul/Champaign County CoC",429,416,13,271,260,11,102,98,4,2008,NA,NA,NA,NA,NA,NA,NA,NA
"503","IL","504","Madison County CoC",214,189,25,145,141,4,44,43,1,2008,NA,NA,NA,NA,NA,NA,NA,NA
"504","IL","506","Joliet, Bolingbrook/Will County CoC",309,299,10,151,151,0,52,52,0,2008,NA,NA,NA,NA,NA,NA,NA,NA
"505","IL","507","Peoria, Pekin/Fulton, Tazewell, Peoria, Woodford Counties CoC",350,342,8,148,148,0,44,44,0,2008,NA,NA,NA,NA,NA,NA,NA,NA
"506","IL","508","East St. Louis, Belleville/St. Clair County CoC",670,218,452,364,132,232,98,46,52,2008,NA,NA,NA,NA,NA,NA,NA,NA
"507","IL","509","Dekalb City & County CoC",130,106,24,70,58,12,23,19,4,2008,NA,NA,NA,NA,NA,NA,NA,NA
"508","IL","510","Chicago CoC",5979,4346,1633,2052,1987,65,598,576,22,2008,NA,NA,NA,NA,NA,NA,NA,NA
"509","IL","511","Cook County CoC",1420,1162,258,699,690,9,328,325,3,2008,NA,NA,NA,NA,NA,NA,NA,NA
"510","IL","512","Bloomington/Central Illinois CoC",467,399,68,239,214,25,73,67,6,2008,NA,NA,NA,NA,NA,NA,NA,NA
"511","IL","513","Springfield/Sangamon County CoC",235,228,7,19,19,0,6,6,0,2008,NA,NA,NA,NA,NA,NA,NA,NA
"512","IL","514","DuPage County CoC",766,642,124,386,364,22,131,123,8,2008,NA,NA,NA,NA,NA,NA,NA,NA
"513","IL","515","South Central Illinois CoC",270,235,35,225,201,24,65,58,7,2008,NA,NA,NA,NA,NA,NA,NA,NA
"514","IL","516","Decatur/Macon County CoC",347,167,180,223,102,121,73,37,36,2008,NA,NA,NA,NA,NA,NA,NA,NA
"515","IL","517","Aurora, Elgin/Kane County CoC",474,418,56,118,118,0,36,36,0,2008,NA,NA,NA,NA,NA,NA,NA,NA
"516","IL","518","Rock Island, Moline/Northwestern Illinois CoC",352,268,84,194,164,30,66,55,11,2008,NA,NA,NA,NA,NA,NA,NA,NA
"517","IL","519","West Central Illinois CoC",229,99,130,61,52,9,24,21,3,2008,NA,NA,NA,NA,NA,NA,NA,NA
"518","IL","520","Southern Illinois CoC",870,796,74,454,438,16,123,117,6,2008,NA,NA,NA,NA,NA,NA,NA,NA
"519","IN","502","Indiana Balance of State CoC",5904,4559,1345,2092,1940,152,691,650,41,2008,NA,NA,NA,NA,NA,NA,NA,NA
"520","IN","503","Indianapolis CoC",1491,1364,127,366,366,0,124,124,0,2008,NA,NA,NA,NA,NA,NA,NA,NA
"521","KS","502","Wichita/Sedgwick County CoC",473,445,28,131,128,3,46,45,1,2008,NA,NA,NA,NA,NA,NA,NA,NA
"522","KS","503","Topeka/Shawnee County CoC",341,316,25,142,142,0,51,51,0,2008,NA,NA,NA,NA,NA,NA,NA,NA
"523","KS","505","Overland Park, Shawnee/Johnson County CoC",234,147,87,174,130,44,50,40,10,2008,NA,NA,NA,NA,NA,NA,NA,NA
"524","KS","507","Kansas Balance of State CoC",524,483,41,151,148,3,45,44,1,2008,NA,NA,NA,NA,NA,NA,NA,NA
"525","KY","500","Kentucky Balance of State CoC",4027,2416,1611,2314,1505,809,599,422,177,2008,NA,NA,NA,NA,NA,NA,NA,NA
"526","KY","501","Louisville-Jefferson County CoC",2682,2537,145,961,961,0,377,377,0,2008,NA,NA,NA,NA,NA,NA,NA,NA
"527","KY","502","Lexington-Fayette County CoC",1428,1242,186,518,482,36,187,176,11,2008,NA,NA,NA,NA,NA,NA,NA,NA
"528","LA","500","Lafayette/Acadiana CoC",631,457,174,326,243,83,104,79,25,2008,NA,NA,NA,NA,NA,NA,NA,NA
"529","LA","502","Shreveport, Bossier/Northwest Louisiana CoC",1042,898,144,553,509,44,186,172,14,2008,NA,NA,NA,NA,NA,NA,NA,NA
"530","LA","503","New Orleans/Jefferson Parish CoC",1619,990,629,818,486,332,262,159,103,2008,NA,NA,NA,NA,NA,NA,NA,NA
"531","LA","505","Monroe/Northeast Louisiana CoC",276,201,75,167,114,53,58,41,17,2008,NA,NA,NA,NA,NA,NA,NA,NA
"532","LA","506","Slidell/Southeast Louisiana CoC",522,210,312,281,136,145,91,45,46,2008,NA,NA,NA,NA,NA,NA,NA,NA
"533","LA","507","Alexandria/Central Louisiana CoC",128,93,35,36,31,5,15,13,2,2008,NA,NA,NA,NA,NA,NA,NA,NA
"534","LA","509","Louisiana Balance of State CoC",1263,851,412,406,276,130,135,94,41,2008,NA,NA,NA,NA,NA,NA,NA,NA
"535","MA","500","Boston CoC",5198,5014,184,2515,2515,0,885,885,0,2008,NA,NA,NA,NA,NA,NA,NA,NA
"536","MA","501","Holyoke/Franklin, Hampden, Hampshire Counties CoC",1090,1013,77,647,630,17,181,175,6,2008,NA,NA,NA,NA,NA,NA,NA,NA
"537","MA","502","Lynn CoC",389,350,39,137,137,0,66,66,0,2008,NA,NA,NA,NA,NA,NA,NA,NA
"538","MA","503","Cape Cod Islands CoC",741,424,317,388,245,143,131,91,40,2008,NA,NA,NA,NA,NA,NA,NA,NA
"539","MA","504","Springfield/Hampden County CoC",696,676,20,367,367,0,135,135,0,2008,NA,NA,NA,NA,NA,NA,NA,NA
"540","MA","505","New Bedford CoC",380,299,81,101,101,0,48,48,0,2008,NA,NA,NA,NA,NA,NA,NA,NA
"541","MA","506","Worcester City & County CoC",1291,1257,34,705,705,0,246,246,0,2008,NA,NA,NA,NA,NA,NA,NA,NA
"542","MA","507","Pittsfield/Berkshire, Franklin, Hampshire Counties CoC",237,210,27,56,51,5,23,22,1,2008,NA,NA,NA,NA,NA,NA,NA,NA
"543","MA","508","Lowell CoC",398,390,8,190,190,0,73,73,0,2008,NA,NA,NA,NA,NA,NA,NA,NA
"544","MA","509","Cambridge CoC",486,424,62,127,127,0,51,51,0,2008,NA,NA,NA,NA,NA,NA,NA,NA
"545","MA","510","Gloucester, Haverhill, Salem/Essex County CoC",656,625,31,289,289,0,106,106,0,2008,NA,NA,NA,NA,NA,NA,NA,NA
"546","MA","511","Quincy, Brockton, Weymouth, Plymouth City and County CoC",901,824,77,517,517,0,194,194,0,2008,NA,NA,NA,NA,NA,NA,NA,NA
"547","MA","514","Framingham/Waltham CoC",636,629,7,463,463,0,172,172,0,2008,NA,NA,NA,NA,NA,NA,NA,NA
"548","MA","515","Fall River CoC",143,138,5,56,56,0,24,24,0,2008,NA,NA,NA,NA,NA,NA,NA,NA
"549","MA","516","Massachusetts Balance of State CoC",952,884,68,683,683,0,255,255,0,2008,NA,NA,NA,NA,NA,NA,NA,NA
"550","MA","517","Somerville CoC",179,177,2,72,72,0,31,31,0,2008,NA,NA,NA,NA,NA,NA,NA,NA
"551","MA","519","Attleboro, Taunton/Bristol County CoC",133,103,30,66,66,0,23,23,0,2008,NA,NA,NA,NA,NA,NA,NA,NA
"552","MD","500","Cumberland/Allegany County CoC",132,83,49,96,61,35,42,22,20,2008,NA,NA,NA,NA,NA,NA,NA,NA
"553","MD","501","Baltimore CoC",2607,1978,629,954,608,346,318,213,105,2008,NA,NA,NA,NA,NA,NA,NA,NA
"554","MD","502","Harford County CoC",145,132,13,51,51,0,17,17,0,2008,NA,NA,NA,NA,NA,NA,NA,NA
"555","MD","503","Annapolis/Anne Arundel County CoC",290,240,50,158,158,0,49,49,0,2008,NA,NA,NA,NA,NA,NA,NA,NA
"556","MD","504","Howard County CoC",159,135,24,124,115,9,27,23,4,2008,NA,NA,NA,NA,NA,NA,NA,NA
"557","MD","505","Baltimore County CoC",426,393,33,293,274,19,106,98,8,2008,NA,NA,NA,NA,NA,NA,NA,NA
"558","MD","506","Carroll County CoC",174,161,13,50,48,2,19,18,1,2008,NA,NA,NA,NA,NA,NA,NA,NA
"559","MD","507","Cecil County CoC",152,139,13,84,84,0,29,29,0,2008,NA,NA,NA,NA,NA,NA,NA,NA
"560","MD","508","Charles, Calvert, St.Mary's Counties CoC",1938,253,1685,1347,150,1197,419,45,374,2008,NA,NA,NA,NA,NA,NA,NA,NA
"561","MD","509","Frederick City & County CoC",246,224,22,120,116,4,42,40,2,2008,NA,NA,NA,NA,NA,NA,NA,NA
"562","MD","510","Garrett County CoC",82,63,19,49,39,10,24,19,5,2008,NA,NA,NA,NA,NA,NA,NA,NA
"563","MD","511","Mid-Shore Regional CoC",310,139,171,111,64,47,32,19,13,2008,NA,NA,NA,NA,NA,NA,NA,NA
"564","MD","512","Hagerstown/Washington County CoC",214,192,22,105,87,18,20,17,3,2008,NA,NA,NA,NA,NA,NA,NA,NA
"565","MD","513","Wicomico, Somerset, Worcester Counties CoC",251,214,37,91,84,7,39,36,3,2008,NA,NA,NA,NA,NA,NA,NA,NA
"566","MD","600","Prince George's County CoC",943,798,145,370,370,0,104,104,0,2008,NA,NA,NA,NA,NA,NA,NA,NA
"567","MD","601","Montgomery County CoC",1150,910,240,410,410,0,130,130,0,2008,NA,NA,NA,NA,NA,NA,NA,NA
"568","ME","500","Maine Statewide CoC",2632,2588,44,1391,1387,4,491,489,2,2008,NA,NA,NA,NA,NA,NA,NA,NA
"569","MI","500","Michigan Balance of State CoC",2355,1386,969,1341,890,451,446,291,155,2008,NA,NA,NA,NA,NA,NA,NA,NA
"570","MI","501","Detroit CoC",18062,4738,13324,6149,1103,5046,1520,386,1134,2008,NA,NA,NA,NA,NA,NA,NA,NA
"571","MI","502","Dearborn, Dearborn Heights, Westland/Wayne County CoC",865,618,247,352,202,150,97,54,43,2008,NA,NA,NA,NA,NA,NA,NA,NA
"572","MI","503","St. Clair Shores, Warren/Macomb County CoC",769,251,518,228,83,145,77,26,51,2008,NA,NA,NA,NA,NA,NA,NA,NA
"573","MI","504","Pontiac, Royal Oak/Oakland County CoC",1011,402,609,207,200,7,51,50,1,2008,NA,NA,NA,NA,NA,NA,NA,NA
"574","MI","505","Flint/Genesee County CoC",245,227,18,116,108,8,40,37,3,2008,NA,NA,NA,NA,NA,NA,NA,NA
"575","MI","506","Grand Rapids, Wyoming/Kent County CoC",794,752,42,387,381,6,132,129,3,2008,NA,NA,NA,NA,NA,NA,NA,NA
"576","MI","507","Portage, Kalamazoo City & County CoC",862,783,79,586,550,36,148,134,14,2008,NA,NA,NA,NA,NA,NA,NA,NA
"577","MI","508","Lansing, East Lansing/Ingham County CoC",408,391,17,203,203,0,77,77,0,2008,NA,NA,NA,NA,NA,NA,NA,NA
"578","MI","509","Washtenaw County CoC",413,357,56,128,128,0,39,39,0,2008,NA,NA,NA,NA,NA,NA,NA,NA
"579","MI","510","Saginaw City & County CoC",361,274,87,124,96,28,43,34,9,2008,NA,NA,NA,NA,NA,NA,NA,NA
"580","MI","511","Lenawee County CoC",93,85,8,48,42,6,16,14,2,2008,NA,NA,NA,NA,NA,NA,NA,NA
"581","MI","512","Grand Traverse, Antrim, Leelanau Counties CoC",241,216,25,76,76,0,26,26,0,2008,NA,NA,NA,NA,NA,NA,NA,NA
"582","MI","513","Marquette, Alger Counties CoC",37,37,0,21,21,0,8,8,0,2008,NA,NA,NA,NA,NA,NA,NA,NA
"583","MI","514","Battle Creek/Calhoun County CoC",274,164,110,81,73,8,27,23,4,2008,NA,NA,NA,NA,NA,NA,NA,NA
"584","MI","515","Monroe City & County CoC",142,131,11,33,33,0,12,12,0,2008,NA,NA,NA,NA,NA,NA,NA,NA
"585","MI","516","Norton Shores, Muskegon City & County CoC",351,171,180,238,83,155,76,29,47,2008,NA,NA,NA,NA,NA,NA,NA,NA
"586","MI","517","Jackson City & County CoC",414,344,70,197,183,14,69,64,5,2008,NA,NA,NA,NA,NA,NA,NA,NA
"587","MI","518","Livingston County CoC",63,58,5,38,38,0,13,13,0,2008,NA,NA,NA,NA,NA,NA,NA,NA
"588","MI","519","Holland/Ottawa County CoC",291,291,0,171,171,0,46,46,0,2008,NA,NA,NA,NA,NA,NA,NA,NA
"589","MI","523","Eaton County CoC",197,105,92,160,103,57,43,26,17,2008,NA,NA,NA,NA,NA,NA,NA,NA
"590","MN","500","Minneapolis/Hennepin County CoC",3369,2813,556,1699,1663,36,529,517,12,2008,NA,NA,NA,NA,NA,NA,NA,NA
"591","MN","501","Saint Paul/Ramsey County CoC",1294,1170,124,676,667,9,216,213,3,2008,NA,NA,NA,NA,NA,NA,NA,NA
"592","MN","502","Rochester/Southeast Minnesota CoC",446,413,33,303,286,17,91,84,7,2008,NA,NA,NA,NA,NA,NA,NA,NA
"593","MN","503","Dakota, Anoka, Washington, Scott, Carver Counties",800,664,136,659,569,90,210,186,24,2008,NA,NA,NA,NA,NA,NA,NA,NA
"594","MN","504","Northeast Minnesota CoC",230,114,116,132,76,56,40,22,18,2008,NA,NA,NA,NA,NA,NA,NA,NA
"595","MN","505","St. Cloud/Central Minnesota CoC",389,313,76,202,169,33,71,60,11,2008,NA,NA,NA,NA,NA,NA,NA,NA
"596","MN","506","Northwest Minnesota CoC",230,199,31,155,147,8,57,54,3,2008,NA,NA,NA,NA,NA,NA,NA,NA
"597","MN","508","Moorhead/West Central Minnesota CoC",242,165,77,98,90,8,35,31,4,2008,NA,NA,NA,NA,NA,NA,NA,NA
"598","MN","509","Duluth/St.Louis County CoC",501,294,207,231,189,42,75,63,12,2008,NA,NA,NA,NA,NA,NA,NA,NA
"599","MN","511","Southwest Minnesota CoC",143,125,18,101,97,4,29,28,1,2008,NA,NA,NA,NA,NA,NA,NA,NA
"600","MO","500","St. Louis County CoC",458,396,62,343,332,11,107,104,3,2008,NA,NA,NA,NA,NA,NA,NA,NA
"601","MO","501","St.Louis City CoC",1386,1173,213,586,586,0,196,196,0,2008,NA,NA,NA,NA,NA,NA,NA,NA
"602","MO","503","St. Charles City & County, Lincoln, Warren Counties CoC",593,305,288,340,179,161,123,65,58,2008,NA,NA,NA,NA,NA,NA,NA,NA
"603","MO","600","Springfield/Greene, Christian, Webster Counties CoC",713,506,207,262,202,60,115,65,50,2008,NA,NA,NA,NA,NA,NA,NA,NA
"604","MO","602","Joplin/Jasper, Newton Counties CoC",380,307,73,98,98,0,31,31,0,2008,NA,NA,NA,NA,NA,NA,NA,NA
"605","MO","603","St. Joseph/Andrew, Buchanan, DeKalb Counties CoC",159,131,28,87,80,7,21,20,1,2008,NA,NA,NA,NA,NA,NA,NA,NA
"606","MO","604a","Kansas City, Independence, Lee’s Summit/Jackson, Wyandotte Counties, MO & KS",2260,1669,591,998,764,234,292,229,63,2008,NA,NA,NA,NA,NA,NA,NA,NA
"607","MO","606","Missouri Balance of State CoC",1904,1229,675,838,637,201,258,200,58,2008,NA,NA,NA,NA,NA,NA,NA,NA
"608","MS","500","Jackson/Rankin, Madison Counties CoC",1302,795,507,94,92,2,28,27,1,2008,NA,NA,NA,NA,NA,NA,NA,NA
"609","MS","501","Mississippi Balance of State CoC",385,344,41,152,152,0,42,42,0,2008,NA,NA,NA,NA,NA,NA,NA,NA
"610","MS","503","Gulf Port/Gulf Coast Regional CoC",274,67,207,18,14,4,7,5,2,2008,NA,NA,NA,NA,NA,NA,NA,NA
"611","MT","500","Montana Statewide CoC",1417,1007,410,449,390,59,154,133,21,2008,NA,NA,NA,NA,NA,NA,NA,NA
"612","NC","500","Winston-Salem/Forsyth County CoC",452,423,29,86,86,0,28,28,0,2008,NA,NA,NA,NA,NA,NA,NA,NA
"613","NC","501","Asheville/Buncombe County CoC",509,429,80,102,99,3,34,31,3,2008,NA,NA,NA,NA,NA,NA,NA,NA
"614","NC","502","Durham City & County CoC",590,554,36,116,116,0,38,38,0,2008,NA,NA,NA,NA,NA,NA,NA,NA
"615","NC","503","North Carolina Balance of State CoC",2742,1830,912,1229,818,411,453,283,170,2008,NA,NA,NA,NA,NA,NA,NA,NA
"616","NC","504","Greensboro, High Point CoC",987,879,108,307,295,12,95,90,5,2008,NA,NA,NA,NA,NA,NA,NA,NA
"617","NC","505","Charlotte/Mecklenberg CoC",1988,1550,438,469,461,8,170,162,8,2008,NA,NA,NA,NA,NA,NA,NA,NA
"618","NC","506","Wilmington/Brunswick, New Hanover, Pender Counties CoC",496,427,69,177,175,2,44,43,1,2008,NA,NA,NA,NA,NA,NA,NA,NA
"619","NC","507","Raleigh/Wake County CoC",1144,1071,73,318,318,0,122,122,0,2008,NA,NA,NA,NA,NA,NA,NA,NA
"620","NC","509","Gastonia/Cleveland, Gaston, Lincoln Counties CoC",920,257,663,160,65,95,50,21,29,2008,NA,NA,NA,NA,NA,NA,NA,NA
"621","NC","511","Fayetteville/Cumberland County CoC",1074,266,808,468,172,296,117,38,79,2008,NA,NA,NA,NA,NA,NA,NA,NA
"622","NC","513","Chapel Hill/Orange County CoC",195,177,18,39,36,3,15,14,1,2008,NA,NA,NA,NA,NA,NA,NA,NA
"623","NC","516","Northwest North Carolina CoC",1314,162,1152,191,47,144,65,17,48,2008,NA,NA,NA,NA,NA,NA,NA,NA
"624","ND","500","North Dakota Statewide CoC",615,596,19,240,234,6,72,70,2,2008,NA,NA,NA,NA,NA,NA,NA,NA
"625","NE","500","Nebraska Balance of State CoC",1637,1237,400,1029,780,249,344,252,92,2008,NA,NA,NA,NA,NA,NA,NA,NA
"626","NE","501","Omaha, Council Bluffs CoC",1197,1125,72,269,269,0,89,89,0,2008,NA,NA,NA,NA,NA,NA,NA,NA
"627","NE","502","Lincoln CoC",1151,865,286,443,354,89,179,111,68,2008,NA,NA,NA,NA,NA,NA,NA,NA
"628","NH","500","New Hampshire Balance of State CoC",986,830,156,443,386,57,118,97,21,2008,NA,NA,NA,NA,NA,NA,NA,NA
"629","NH","501","Manchester CoC",576,373,203,171,168,3,54,53,1,2008,NA,NA,NA,NA,NA,NA,NA,NA
"630","NH","502","Nashua/Hillsborough County CoC",457,332,125,233,196,37,78,65,13,2008,NA,NA,NA,NA,NA,NA,NA,NA
"631","NJ","500","Atlantic City & County CoC",476,398,78,94,88,6,40,37,3,2008,NA,NA,NA,NA,NA,NA,NA,NA
"632","NJ","501","Bergen County CoC",1627,1514,113,937,927,10,333,328,5,2008,NA,NA,NA,NA,NA,NA,NA,NA
"633","NJ","502","Burlington County CoC",896,780,116,286,272,14,152,145,7,2008,NA,NA,NA,NA,NA,NA,NA,NA
"634","NJ","503","Camden City & County/Gloucester, Cape May, Cumberland Counties CoC",1454,1111,343,598,482,116,184,155,29,2008,NA,NA,NA,NA,NA,NA,NA,NA
"635","NJ","504","Newark/Essex County CoC",1036,884,152,353,316,37,84,69,15,2008,NA,NA,NA,NA,NA,NA,NA,NA
"636","NJ","506","Jersey City, Bayonne/Hudson County CoC",2227,1976,251,1545,1472,73,548,532,16,2008,NA,NA,NA,NA,NA,NA,NA,NA
"637","NJ","507","New Brunswick/Middlesex County CoC",792,545,247,398,284,114,125,99,26,2008,NA,NA,NA,NA,NA,NA,NA,NA
"638","NJ","508","Monmouth County CoC",763,676,87,452,421,31,140,132,8,2008,NA,NA,NA,NA,NA,NA,NA,NA
"639","NJ","509","Morris County CoC",224,189,35,76,76,0,30,30,0,2008,NA,NA,NA,NA,NA,NA,NA,NA
"640","NJ","510","Lakewood Township/Ocean County CoC",337,309,28,149,149,0,51,51,0,2008,NA,NA,NA,NA,NA,NA,NA,NA
"641","NJ","511","Paterson/Passaic County CoC",518,314,204,180,134,46,58,49,9,2008,NA,NA,NA,NA,NA,NA,NA,NA
"642","NJ","512","Salem County CoC",310,302,8,174,171,3,59,58,1,2008,NA,NA,NA,NA,NA,NA,NA,NA
"643","NJ","513","Somerset County CoC",302,285,17,125,122,3,36,35,1,2008,NA,NA,NA,NA,NA,NA,NA,NA
"644","NJ","514","Trenton/Mercer County CoC",989,851,138,467,401,66,110,93,17,2008,NA,NA,NA,NA,NA,NA,NA,NA
"645","NJ","515","Elizabeth/Union County CoC",1188,1072,116,765,753,12,272,270,2,2008,NA,NA,NA,NA,NA,NA,NA,NA
"646","NJ","516","Warren, Sussex, Hunterdon Counties CoC",693,654,39,385,371,14,137,133,4,2008,NA,NA,NA,NA,NA,NA,NA,NA
"647","NM","500","Albuquerque CoC",1276,989,287,455,383,72,147,124,23,2008,NA,NA,NA,NA,NA,NA,NA,NA
"648","NM","501","New Mexico Balance of State CoC",1739,759,980,699,302,397,220,102,118,2008,NA,NA,NA,NA,NA,NA,NA,NA
"649","NV","500","Las Vegas/Clark County CoC",7533,3844,3689,1909,942,967,606,285,321,2008,NA,NA,NA,NA,NA,NA,NA,NA
"650","NV","501","Reno, Sparks/Washoe County CoC",863,765,98,121,118,3,40,39,1,2008,NA,NA,NA,NA,NA,NA,NA,NA
"651","NV","502","Nevada Balance of State CoC",330,254,76,184,145,39,63,56,7,2008,NA,NA,NA,NA,NA,NA,NA,NA
"652","NY","500","Rochester, Irondequoit, Greece/Monroe County CoC",595,591,4,275,275,0,112,112,0,2008,NA,NA,NA,NA,NA,NA,NA,NA
"653","NY","501","Elmira/Steuben, Allegany, Livingston, Chemung, Schuyler Counties CoC",177,176,1,26,26,0,9,9,0,2008,NA,NA,NA,NA,NA,NA,NA,NA
"654","NY","503","Albany City & County CoC",538,466,72,154,145,9,56,53,3,2008,NA,NA,NA,NA,NA,NA,NA,NA
"655","NY","504","Cattaragus County CoC",69,54,15,21,21,0,8,8,0,2008,NA,NA,NA,NA,NA,NA,NA,NA
"656","NY","505","Syracuse, Auburn/Onondaga, Oswego, Cayuga Counties CoC",731,708,23,131,125,6,51,46,5,2008,NA,NA,NA,NA,NA,NA,NA,NA
"657","NY","507","Schenectady City & County CoC",195,129,66,43,36,7,15,12,3,2008,NA,NA,NA,NA,NA,NA,NA,NA
"658","NY","508","Buffalo, Niagara Falls/Erie, Niagara, Orleans, Genesee, Wyoming Counties CoC",1250,1031,219,413,401,12,127,123,4,2008,NA,NA,NA,NA,NA,NA,NA,NA
"659","NY","510","Ithaca/Tompkins County CoC",78,62,16,32,32,0,10,10,0,2008,NA,NA,NA,NA,NA,NA,NA,NA
"660","NY","512","Troy/Rensselaer County CoC",193,134,59,105,100,5,39,37,2,2008,NA,NA,NA,NA,NA,NA,NA,NA
"661","NY","513","Wayne, Ontario, Seneca, Yates Counties CoC",88,88,0,41,41,0,16,16,0,2008,NA,NA,NA,NA,NA,NA,NA,NA
"662","NY","514","Jamestown, Dunkirk/Chautauqua County CoC",65,63,2,56,56,0,26,26,0,2008,NA,NA,NA,NA,NA,NA,NA,NA
"663","NY","516","Clinton County CoC",53,48,5,3,3,0,1,1,0,2008,NA,NA,NA,NA,NA,NA,NA,NA
"664","NY","518","Utica, Rome/Oneida, Madison Counties CoC",316,300,16,130,130,0,40,40,0,2008,NA,NA,NA,NA,NA,NA,NA,NA
"665","NY","519","Columbia, Greene Counties CoC",172,172,0,76,76,0,26,26,0,2008,NA,NA,NA,NA,NA,NA,NA,NA
"666","NY","520","Franklin, Essex Counties CoC",10,6,4,0,0,0,0,0,0,2008,NA,NA,NA,NA,NA,NA,NA,NA
"667","NY","522","Jefferson, Lewis, St. Lawrence Counties CoC",297,292,5,48,48,0,14,14,0,2008,NA,NA,NA,NA,NA,NA,NA,NA
"668","NY","523","Glens Falls, Saratoga Springs/Saratoga, Washington, Warren, Hamilton Counties Co",166,117,49,56,44,12,20,17,3,2008,NA,NA,NA,NA,NA,NA,NA,NA
"669","NY","600","New York City CoC",50261,46955,3306,30267,30267,0,9453,9453,0,2008,NA,NA,NA,NA,NA,NA,NA,NA
"670","NY","601","Poughkeepsie/Dutchess County CoC",547,463,84,259,230,29,93,83,10,2008,NA,NA,NA,NA,NA,NA,NA,NA
"671","NY","602","Newburgh, Middletown/Orange County CoC",311,217,94,103,95,8,35,32,3,2008,NA,NA,NA,NA,NA,NA,NA,NA
"672","NY","603","Nassau, Suffolk Counties CoC",2509,2351,158,1720,1720,0,534,534,0,2008,NA,NA,NA,NA,NA,NA,NA,NA
"673","NY","604","Yonkers, Mount Vernon/Westchester County CoC",1829,1693,136,1139,1139,0,365,365,0,2008,NA,NA,NA,NA,NA,NA,NA,NA
"674","NY","606","Rockland County CoC",141,84,57,50,50,0,21,21,0,2008,NA,NA,NA,NA,NA,NA,NA,NA
"675","NY","607","Sullivan County CoC",139,109,30,86,77,9,25,23,2,2008,NA,NA,NA,NA,NA,NA,NA,NA
"676","NY","608","Kingston/Ulster County CoC",395,207,188,120,75,45,36,23,13,2008,NA,NA,NA,NA,NA,NA,NA,NA
"677","OH","500","Cincinnati/Hamilton County CoC",1116,1061,55,390,390,0,118,118,0,2008,NA,NA,NA,NA,NA,NA,NA,NA
"678","OH","501","Toledo/Lucas County CoC",959,705,254,306,228,78,106,73,33,2008,NA,NA,NA,NA,NA,NA,NA,NA
"679","OH","502","Cleveland/Cuyahoga County CoC",2242,2091,151,452,442,10,149,146,3,2008,NA,NA,NA,NA,NA,NA,NA,NA
"680","OH","503","Columbus/Franklin County CoC",1341,1224,117,490,490,0,148,148,0,2008,NA,NA,NA,NA,NA,NA,NA,NA
"681","OH","504","Youngstown/Mahoning County CoC",236,225,11,115,115,0,41,41,0,2008,NA,NA,NA,NA,NA,NA,NA,NA
"682","OH","505","Dayton, Kettering/Montgomery County CoC",844,814,30,360,360,0,119,119,0,2008,NA,NA,NA,NA,NA,NA,NA,NA
"683","OH","506","Akron, Barberton/Summit County CoC",740,636,104,250,243,7,82,80,2,2008,NA,NA,NA,NA,NA,NA,NA,NA
"684","OH","507","Ohio Balance of State CoC",4525,3225,1300,2283,1762,521,758,582,176,2008,NA,NA,NA,NA,NA,NA,NA,NA
"685","OH","508","Canton, Massillon, Alliance/Stark County CoC",909,396,513,401,231,170,128,75,53,2008,NA,NA,NA,NA,NA,NA,NA,NA
"686","OK","500","North Central Oklahoma CoC",241,215,26,105,102,3,34,33,1,2008,NA,NA,NA,NA,NA,NA,NA,NA
"687","OK","501","Tulsa City & County CoC",729,694,35,153,148,5,50,48,2,2008,NA,NA,NA,NA,NA,NA,NA,NA
"688","OK","502","Oklahoma City CoC",1335,1013,322,282,251,31,96,84,12,2008,NA,NA,NA,NA,NA,NA,NA,NA
"689","OK","503","Oklahoma Balance of State CoC",157,151,6,59,59,0,21,21,0,2008,NA,NA,NA,NA,NA,NA,NA,NA
"690","OK","504","Norman/Cleveland County CoC",578,178,400,274,86,188,85,35,50,2008,NA,NA,NA,NA,NA,NA,NA,NA
"691","OK","505","Northeast Oklahoma CoC",370,202,168,113,73,40,36,23,13,2008,NA,NA,NA,NA,NA,NA,NA,NA
"692","OK","506","Southwest Oklahoma Regional CoC",168,152,16,58,55,3,20,19,1,2008,NA,NA,NA,NA,NA,NA,NA,NA
"693","OK","507","Southeastern Oklahoma Regional CoC",268,198,70,128,124,4,35,33,2,2008,NA,NA,NA,NA,NA,NA,NA,NA
"694","OR","500","Eugene, Springfield/Lane County CoC",2137,1365,772,962,669,293,290,224,66,2008,NA,NA,NA,NA,NA,NA,NA,NA
"695","OR","501","Portland, Gresham/Multnomah County CoC",3918,2284,1634,913,842,71,317,287,30,2008,NA,NA,NA,NA,NA,NA,NA,NA
"696","OR","502","Medford, Ashland/Jackson County CoC",654,628,26,288,288,0,119,119,0,2008,NA,NA,NA,NA,NA,NA,NA,NA
"697","OR","503","Central Oregon CoC",1736,270,1466,1153,158,995,358,49,309,2008,NA,NA,NA,NA,NA,NA,NA,NA
"698","OR","505","Oregon Balance of State CoC",9860,4870,4990,4855,2266,2589,1567,733,834,2008,NA,NA,NA,NA,NA,NA,NA,NA
"699","OR","506","Hillsboro, Beaverton/Washington County CoC",772,363,409,516,338,178,169,117,52,2008,NA,NA,NA,NA,NA,NA,NA,NA
"700","OR","507","Clackamas County CoC",1576,166,1410,418,125,293,124,44,80,2008,NA,NA,NA,NA,NA,NA,NA,NA
"701","PA","500","Philadelphia CoC",6871,6414,457,3392,3392,0,1087,1087,0,2008,NA,NA,NA,NA,NA,NA,NA,NA
"702","PA","501","Harrisburg/Dauphin County CoC",421,355,66,193,184,9,72,69,3,2008,NA,NA,NA,NA,NA,NA,NA,NA
"703","PA","502","Upper Darby, Chester, Haverford/Delaware County CoC",653,610,43,405,405,0,128,128,0,2008,NA,NA,NA,NA,NA,NA,NA,NA
"704","PA","503","Wilkes-Barre, Hazleton/Luzerne County CoC",171,161,10,64,64,0,21,21,0,2008,NA,NA,NA,NA,NA,NA,NA,NA
"705","PA","504","Lower Merion, Norristown, Abington/Montgomery County CoC",479,455,24,303,303,0,92,92,0,2008,NA,NA,NA,NA,NA,NA,NA,NA
"706","PA","505","Chester County CoC",314,286,28,184,156,28,65,50,15,2008,NA,NA,NA,NA,NA,NA,NA,NA
"707","PA","506","Reading/Berks County CoC",496,429,67,209,209,0,75,75,0,2008,NA,NA,NA,NA,NA,NA,NA,NA
"708","PA","508","Scranton/Lackawanna County CoC",260,222,38,151,135,16,51,45,6,2008,NA,NA,NA,NA,NA,NA,NA,NA
"709","PA","509","Eastern Pennsylvania CoC",1759,1646,113,986,966,20,332,326,6,2008,NA,NA,NA,NA,NA,NA,NA,NA
"710","PA","510","Lancaster City & County CoC",707,668,39,321,321,0,129,129,0,2008,NA,NA,NA,NA,NA,NA,NA,NA
"711","PA","511","Bristol, Bensalem/Bucks County CoC",485,481,4,335,335,0,104,104,0,2008,NA,NA,NA,NA,NA,NA,NA,NA
"712","PA","600","Pittsburgh, McKeesport, Penn Hills/Allegheny County CoC",1308,1088,220,471,471,0,164,164,0,2008,NA,NA,NA,NA,NA,NA,NA,NA
"713","PA","601","Western Pennsylvania CoC",862,795,67,428,416,12,141,136,5,2008,NA,NA,NA,NA,NA,NA,NA,NA
"714","PA","603","Beaver County CoC",213,131,82,24,21,3,8,7,1,2008,NA,NA,NA,NA,NA,NA,NA,NA
"715","PA","605","Erie City & County CoC",379,338,41,178,160,18,57,50,7,2008,NA,NA,NA,NA,NA,NA,NA,NA
"716","RI","500","Rhode Island Statewide CoC",1196,1142,54,482,482,0,181,181,0,2008,NA,NA,NA,NA,NA,NA,NA,NA
"717","SC","500","Charleston/Low Country CoC",539,482,57,107,101,6,40,37,3,2008,NA,NA,NA,NA,NA,NA,NA,NA
"718","SC","501","Greenville, Anderson, Spartanburg/Upstate CoC",1606,1100,506,479,391,88,154,132,22,2008,NA,NA,NA,NA,NA,NA,NA,NA
"719","SC","502","Columbia/Midlands CoC",1569,946,623,291,226,65,97,78,19,2008,NA,NA,NA,NA,NA,NA,NA,NA
"720","SC","503","Myrtle Beach, Sumter City & County CoC",1946,558,1388,974,337,637,164,79,85,2008,NA,NA,NA,NA,NA,NA,NA,NA
"721","SD","500","South Dakota Statewide CoC",579,538,41,311,303,8,108,104,4,2008,NA,NA,NA,NA,NA,NA,NA,NA
"722","TN","500","Chattanooga/Southeast Tennessee CoC",87,72,15,87,72,15,37,25,12,2008,NA,NA,NA,NA,NA,NA,NA,NA
"723","TN","501","Memphis/Shelby County CoC",1566,1482,84,559,557,2,215,214,1,2008,NA,NA,NA,NA,NA,NA,NA,NA
"724","TN","502","Knoxville/Knox County CoC",930,816,114,118,110,8,47,44,3,2008,NA,NA,NA,NA,NA,NA,NA,NA
"725","TN","503","Central Tennessee CoC",328,239,89,86,55,31,27,15,12,2008,NA,NA,NA,NA,NA,NA,NA,NA
"726","TN","504","Nashville-Davidson County CoC",2217,1751,466,401,401,0,134,134,0,2008,NA,NA,NA,NA,NA,NA,NA,NA
"727","TN","506","Upper Cumberland CoC",704,196,508,371,80,291,133,29,104,2008,NA,NA,NA,NA,NA,NA,NA,NA
"728","TN","507","Jackson/West Tennessee CoC",2187,251,1936,191,66,125,75,23,52,2008,NA,NA,NA,NA,NA,NA,NA,NA
"729","TN","509","Appalachian Regional CoC",559,345,214,81,73,8,26,23,3,2008,NA,NA,NA,NA,NA,NA,NA,NA
"730","TN","510","Murfreesboro/Rutherford County CoC",223,75,148,47,30,17,16,14,2,2008,NA,NA,NA,NA,NA,NA,NA,NA
"731","TN","512","Morristown/Blount, Sevier, Campbell, Cocke Counties CoC",904,433,471,522,387,135,173,117,56,2008,NA,NA,NA,NA,NA,NA,NA,NA
"732","TX","500","San Antonio/Bexar County CoC",4063,2518,1545,1266,1155,111,419,370,49,2008,NA,NA,NA,NA,NA,NA,NA,NA
"733","TX","503","Austin/Travis County CoC",3451,1305,2146,570,540,30,160,151,9,2008,NA,NA,NA,NA,NA,NA,NA,NA
"734","TX","600","Dallas City & County, Irving CoC",3558,3345,213,1272,1272,0,433,433,0,2008,NA,NA,NA,NA,NA,NA,NA,NA
"735","TX","601","Fort Worth, Arlington/Tarrant County CoC",2676,2473,203,1234,1234,0,394,394,0,2008,NA,NA,NA,NA,NA,NA,NA,NA
"736","TX","603","El Paso City & County CoC",1241,968,273,437,437,0,133,133,0,2008,NA,NA,NA,NA,NA,NA,NA,NA
"737","TX","604","Waco/McLennan County CoC",431,259,172,110,83,27,38,32,6,2008,NA,NA,NA,NA,NA,NA,NA,NA
"738","TX","607","Texas Balance of State CoC",13298,7259,6039,4670,2759,1911,1204,671,533,2008,NA,NA,NA,NA,NA,NA,NA,NA
"739","TX","611","Amarillo CoC",540,486,54,189,189,0,61,61,0,2008,NA,NA,NA,NA,NA,NA,NA,NA
"740","TX","624","Wichita Falls/Wise, Palo Pinto, Wichita, Archer Counties CoC",280,231,49,47,47,0,14,14,0,2008,NA,NA,NA,NA,NA,NA,NA,NA
"741","TX","700","Houston, Pasadena, Conroe/Harris, Ft. Bend, Montgomery, Counties CoC",10363,5017,5346,2309,2157,152,668,623,45,2008,NA,NA,NA,NA,NA,NA,NA,NA
"742","TX","701","Bryan, College Station/Brazos Valley CoC",289,219,70,136,112,24,34,28,6,2008,NA,NA,NA,NA,NA,NA,NA,NA
"743","UT","500","Salt Lake City & County CoC",2296,2138,158,868,868,0,270,270,0,2008,NA,NA,NA,NA,NA,NA,NA,NA
"744","UT","503","Utah Balance of State CoC",878,827,51,402,402,0,139,139,0,2008,NA,NA,NA,NA,NA,NA,NA,NA
"745","UT","504","Provo/Mountainland CoC",260,213,47,146,146,0,47,47,0,2008,NA,NA,NA,NA,NA,NA,NA,NA
"746","VA","500","Richmond/Henrico, Chesterfield, Hanover Counties CoC",1073,907,166,242,242,0,89,89,0,2008,NA,NA,NA,NA,NA,NA,NA,NA
"747","VA","501","Norfolk/Chesapeake, Suffolk, Isle of Wight, Southampton Counties CoC",602,509,93,224,198,26,78,61,17,2008,NA,NA,NA,NA,NA,NA,NA,NA
"748","VA","502","Roanoke City & County, Salem CoC",504,497,7,125,125,0,42,42,0,2008,NA,NA,NA,NA,NA,NA,NA,NA
"749","VA","503","Virginia Beach CoC",484,406,78,251,249,2,80,79,1,2008,NA,NA,NA,NA,NA,NA,NA,NA
"750","VA","504","Charlottesville CoC",239,224,15,56,56,0,17,17,0,2008,NA,NA,NA,NA,NA,NA,NA,NA
"751","VA","505","Newport News, Hampton/Virginia Peninsula CoC",526,486,40,132,130,2,43,42,1,2008,NA,NA,NA,NA,NA,NA,NA,NA
"752","VA","507","Portsmouth CoC",222,177,45,55,55,0,21,21,0,2008,NA,NA,NA,NA,NA,NA,NA,NA
"753","VA","508","Lynchburg CoC",256,211,45,123,122,1,45,44,1,2008,NA,NA,NA,NA,NA,NA,NA,NA
"754","VA","513","Harrisburg, Winchester/Western Virginia CoC",245,188,57,137,106,31,46,32,14,2008,NA,NA,NA,NA,NA,NA,NA,NA
"755","VA","514","Fredericksburg/Spotsylvania, Stafford Counties CoC",194,127,67,71,64,7,25,22,3,2008,NA,NA,NA,NA,NA,NA,NA,NA
"756","VA","521","Virginia Balance of State CoC",863,559,304,420,300,120,150,106,44,2008,NA,NA,NA,NA,NA,NA,NA,NA
"757","VA","600","Arlington County CoC",410,231,179,126,126,0,41,41,0,2008,NA,NA,NA,NA,NA,NA,NA,NA
"758","VA","601","Fairfax County CoC",1835,1623,212,1091,1091,0,311,311,0,2008,NA,NA,NA,NA,NA,NA,NA,NA
"759","VA","602","Loudoun County CoC",160,136,24,117,117,0,33,33,0,2008,NA,NA,NA,NA,NA,NA,NA,NA
"760","VA","603","Alexandria CoC",306,238,68,112,112,0,39,39,0,2008,NA,NA,NA,NA,NA,NA,NA,NA
"761","VA","604","Prince William County CoC",550,376,174,349,261,88,106,81,25,2008,NA,NA,NA,NA,NA,NA,NA,NA
"762","VT","500","Vermont Balance of State CoC",633,439,194,228,199,29,79,69,10,2008,NA,NA,NA,NA,NA,NA,NA,NA
"763","VT","501","Burlington/Chittenden County CoC",321,257,64,99,96,3,41,40,1,2008,NA,NA,NA,NA,NA,NA,NA,NA
"764","WA","500","Seattle/King County CoC",8501,5808,2693,2984,2922,62,931,915,16,2008,NA,NA,NA,NA,NA,NA,NA,NA
"765","WA","501","Washington Balance of State CoC",7117,5005,2112,3947,3106,841,1273,1015,258,2008,NA,NA,NA,NA,NA,NA,NA,NA
"766","WA","502","Spokane City & County CoC",1370,1080,290,371,344,27,129,119,10,2008,NA,NA,NA,NA,NA,NA,NA,NA
"767","WA","503","Tacoma, Lakewood/Pierce County CoC",1743,1478,265,990,952,38,285,280,5,2008,NA,NA,NA,NA,NA,NA,NA,NA
"768","WA","504","Everett/Snohomish County CoC",2161,1205,956,949,842,107,336,300,36,2008,NA,NA,NA,NA,NA,NA,NA,NA
"769","WA","508","Vancouver/Clark County CoC",1062,880,182,557,459,98,169,141,28,2008,NA,NA,NA,NA,NA,NA,NA,NA
"770","WI","500","Wisconsin Balance of State CoC",3105,2817,288,2061,1951,110,715,676,39,2008,NA,NA,NA,NA,NA,NA,NA,NA
"771","WI","501","Milwaukee City & County CoC",1470,1295,175,701,612,89,239,210,29,2008,NA,NA,NA,NA,NA,NA,NA,NA
"772","WI","502","Racine City & County CoC",259,258,1,100,100,0,40,40,0,2008,NA,NA,NA,NA,NA,NA,NA,NA
"773","WI","503","Madison/Dane County CoC",615,564,51,302,296,6,96,93,3,2008,NA,NA,NA,NA,NA,NA,NA,NA
"774","WV","500","Wheeling, Weirton Area CoC",92,85,7,21,21,0,8,8,0,2008,NA,NA,NA,NA,NA,NA,NA,NA
"775","WV","501","Huntington/Cabell, Wayne Counties CoC",264,232,32,60,60,0,22,22,0,2008,NA,NA,NA,NA,NA,NA,NA,NA
"776","WV","503","Charleston/Kanawha, Putnam, Boone, Clay Counties CoC",363,264,99,88,63,25,29,21,8,2008,NA,NA,NA,NA,NA,NA,NA,NA
"777","WV","508","West Virginia Balance of State CoC",1297,841,456,412,285,127,140,111,29,2008,NA,NA,NA,NA,NA,NA,NA,NA
"778","WY","500","Wyoming Statewide CoC",751,619,132,394,299,95,143,116,27,2008,NA,NA,NA,NA,NA,NA,NA,NA
"779",NA,NA,"Total",639784,386361,253423,235259,181506,53753,75750,58649,17101,2008,NA,NA,NA,NA,NA,NA,NA,NA
"780","AK","500","Anchorage CoC",1267,1110,157,446,421,25,133,124,9,2009,NA,NA,NA,NA,NA,NA,NA,NA
"781","AK","501","Alaska Balance of State CoC",725,555,170,307,255,52,104,86,18,2009,NA,NA,NA,NA,NA,NA,NA,NA
"782","AL","500","Birmingham/Jefferson, St. Clair, Shelby Counties CoC",2273,1069,1204,628,313,315,235,117,118,2009,NA,NA,NA,NA,NA,NA,NA,NA
"783","AL","501","Mobile City & County/Baldwin County CoC",747,411,336,175,159,16,57,50,7,2009,NA,NA,NA,NA,NA,NA,NA,NA
"784","AL","502","Florence/Northwest Alabama CoC",281,213,68,59,34,25,26,16,10,2009,NA,NA,NA,NA,NA,NA,NA,NA
"785","AL","503","Huntsville/North Alabama CoC",664,574,90,86,86,0,27,27,0,2009,NA,NA,NA,NA,NA,NA,NA,NA
"786","AL","504","Montgomery City & County CoC",377,263,114,72,54,18,26,19,7,2009,NA,NA,NA,NA,NA,NA,NA,NA
"787","AL","505","Gadsden/Northeast Alabama CoC",433,307,126,100,71,29,41,29,12,2009,NA,NA,NA,NA,NA,NA,NA,NA
"788","AL","506","Tuscaloosa City & County CoC",270,261,9,68,68,0,21,21,0,2009,NA,NA,NA,NA,NA,NA,NA,NA
"789","AL","507","Alabama Balance of State CoC",1035,815,220,206,97,109,76,34,42,2009,NA,NA,NA,NA,NA,NA,NA,NA
"790","AR","500","Little Rock/Central Arkansas CoC",1425,973,452,246,238,8,66,64,2,2009,NA,NA,NA,NA,NA,NA,NA,NA
"791","AR","501","Fayetteville/Northwest Arkansas CoC",221,191,30,119,118,1,50,49,1,2009,NA,NA,NA,NA,NA,NA,NA,NA
"792","AR","502","Conway/Arkansas River Valley",146,34,112,48,8,40,16,3,13,2009,NA,NA,NA,NA,NA,NA,NA,NA
"793","AR","504","Delta Hills CoC",969,459,510,238,49,189,95,20,75,2009,NA,NA,NA,NA,NA,NA,NA,NA
"794","AR","505","Southeast Arkansas CoC",51,51,0,20,20,0,7,7,0,2009,NA,NA,NA,NA,NA,NA,NA,NA
"795","AR","506","Johnson, Pope, Yell Counties",40,22,18,0,0,0,0,0,0,2009,NA,NA,NA,NA,NA,NA,NA,NA
"796","AZ","500","Arizona Balance of State CoC",3236,1172,2064,1019,583,436,295,184,111,2009,NA,NA,NA,NA,NA,NA,NA,NA
"797","AZ","501","Tucson/Pima County CoC",3596,2223,1373,988,967,21,308,301,7,2009,NA,NA,NA,NA,NA,NA,NA,NA
"798","AZ","502","Phoenix, Mesa/Maricopa County CoC",7889,4971,2918,2755,2525,230,803,766,37,2009,NA,NA,NA,NA,NA,NA,NA,NA
"799","CA","500","San Jose/Santa Clara City & County CoC",7086,2103,4983,1008,942,66,285,264,21,2009,NA,NA,NA,NA,NA,NA,NA,NA
"800","CA","501","San Francisco CoC",5823,2881,2942,514,489,25,178,168,10,2009,NA,NA,NA,NA,NA,NA,NA,NA
"801","CA","502","Oakland, Berkeley/Alameda County CoC",4341,2378,1963,1570,1148,422,484,412,72,2009,NA,NA,NA,NA,NA,NA,NA,NA
"802","CA","503","Sacramento City & County CoC",2800,1606,1194,543,527,16,185,179,6,2009,NA,NA,NA,NA,NA,NA,NA,NA
"803","CA","504","Santa Rosa, Petaluma/Sonoma County CoC",3247,1025,2222,488,482,6,165,163,2,2009,NA,NA,NA,NA,NA,NA,NA,NA
"804","CA","505","Richmond/Contra Costa County CoC",2759,887,1872,394,384,10,121,116,5,2009,NA,NA,NA,NA,NA,NA,NA,NA
"805","CA","506","Salinas/Monterey, San Benito Counties CoC",2407,779,1628,498,376,122,117,89,28,2009,NA,NA,NA,NA,NA,NA,NA,NA
"806","CA","507","Marin County CoC",1026,597,429,259,230,29,85,75,10,2009,NA,NA,NA,NA,NA,NA,NA,NA
"807","CA","508","Watsonville/Santa Cruz City & County CoC",2265,729,1536,450,406,44,145,131,14,2009,NA,NA,NA,NA,NA,NA,NA,NA
"808","CA","509","Mendocino County CoC",1202,235,967,131,109,22,44,37,7,2009,NA,NA,NA,NA,NA,NA,NA,NA
"809","CA","510","Turlock, Modesto/Stanislaus County CoC",1800,801,999,682,317,365,281,116,165,2009,NA,NA,NA,NA,NA,NA,NA,NA
"810","CA","511","Stockton/San Joaquin County CoC",3005,2840,165,883,883,0,281,281,0,2009,NA,NA,NA,NA,NA,NA,NA,NA
"811","CA","512","Daly/San Mateo County CoC",1567,764,803,416,341,75,120,100,20,2009,NA,NA,NA,NA,NA,NA,NA,NA
"812","CA","513","Visalia/Kings, Tulare Counties CoC",966,210,756,394,93,301,114,32,82,2009,NA,NA,NA,NA,NA,NA,NA,NA
"813","CA","514","Fresno City & County/Madera County CoC",4345,1888,2457,998,806,192,320,243,77,2009,NA,NA,NA,NA,NA,NA,NA,NA
"814","CA","515","Roseville, Rocklin/Placer, Nevada Counties CoC",1054,572,482,354,265,89,118,91,27,2009,NA,NA,NA,NA,NA,NA,NA,NA
"815","CA","516","Redding/Shasta, Siskiyou, Lassen, Plumas, Del Norte, Modoc, Sierra Counties CoC",340,194,146,135,104,31,42,31,11,2009,NA,NA,NA,NA,NA,NA,NA,NA
"816","CA","517","Napa City & County CoC",314,186,128,53,53,0,16,16,0,2009,NA,NA,NA,NA,NA,NA,NA,NA
"817","CA","518","Vallejo/Solano County CoC",829,403,426,361,206,155,147,87,60,2009,NA,NA,NA,NA,NA,NA,NA,NA
"818","CA","519","Chico, Paradise/Butte County CoC",689,303,386,131,112,19,38,33,5,2009,NA,NA,NA,NA,NA,NA,NA,NA
"819","CA","520","Merced City & County CoC",372,148,224,28,28,0,10,10,0,2009,NA,NA,NA,NA,NA,NA,NA,NA
"820","CA","521","Davis, Woodland/Yolo County CoC",491,202,289,126,110,16,41,34,7,2009,NA,NA,NA,NA,NA,NA,NA,NA
"821","CA","522","Humboldt County CoC",1355,355,1000,466,145,321,138,52,86,2009,NA,NA,NA,NA,NA,NA,NA,NA
"822","CA","523","Colusa, Glenn, Trinity Counties CoC",197,74,123,52,37,15,18,13,5,2009,NA,NA,NA,NA,NA,NA,NA,NA
"823","CA","524","Yuba City & County/Sutter County CoC",411,303,108,242,226,16,75,69,6,2009,NA,NA,NA,NA,NA,NA,NA,NA
"824","CA","525","El Dorado County CoC",146,63,83,48,40,8,15,12,3,2009,NA,NA,NA,NA,NA,NA,NA,NA
"825","CA","526","Amador, Calaveras, Mariposa, Tuolumne Counties CoC",372,150,222,197,120,77,64,42,22,2009,NA,NA,NA,NA,NA,NA,NA,NA
"826","CA","600","Los Angeles City & County CoC",33243,14050,19193,4885,3874,1011,1840,1365,475,2009,NA,NA,NA,NA,NA,NA,NA,NA
"827","CA","601","San Diego City and County CoC",7995,3981,4014,1701,1592,109,554,518,36,2009,NA,NA,NA,NA,NA,NA,NA,NA
"828","CA","602","Santa Ana, Anaheim/Orange County CoC",8333,2609,5724,1377,1296,81,481,454,27,2009,NA,NA,NA,NA,NA,NA,NA,NA
"829","CA","603","Santa Maria/Santa Barbara County CoC",4121,1148,2973,788,402,386,262,135,127,2009,NA,NA,NA,NA,NA,NA,NA,NA
"830","CA","604","Bakersfield/Kern County CoC",1499,667,832,248,203,45,78,60,18,2009,NA,NA,NA,NA,NA,NA,NA,NA
"831","CA","606","Long Beach CoC",3909,2154,1755,709,494,215,224,156,68,2009,NA,NA,NA,NA,NA,NA,NA,NA
"832","CA","607","Pasadena CoC",1144,403,741,226,153,73,93,64,29,2009,NA,NA,NA,NA,NA,NA,NA,NA
"833","CA","608","Riverside City & County CoC",3366,1323,2043,1084,386,698,265,142,123,2009,NA,NA,NA,NA,NA,NA,NA,NA
"834","CA","609","San Bernardino City & County CoC",2026,768,1258,629,461,168,221,176,45,2009,NA,NA,NA,NA,NA,NA,NA,NA
"835","CA","611","Oxnard, San Buenaventura/Ventura County CoC",2193,461,1732,540,161,379,179,61,118,2009,NA,NA,NA,NA,NA,NA,NA,NA
"836","CA","612","Glendale CoC",306,138,168,149,89,60,63,45,18,2009,NA,NA,NA,NA,NA,NA,NA,NA
"837","CA","613","Imperial County CoC",505,157,348,105,105,0,33,33,0,2009,NA,NA,NA,NA,NA,NA,NA,NA
"838","CA","614","San Luis Obispo County CoC",3829,242,3587,2282,165,2117,673,38,635,2009,NA,NA,NA,NA,NA,NA,NA,NA
"839","CO","500","Colorado Balance of State CoC",5267,1087,4180,3943,808,3135,986,202,784,2009,NA,NA,NA,NA,NA,NA,NA,NA
"840","CO","503","Metropolitan Denver CoC",8752,7053,1699,3671,3400,271,1156,1071,85,2009,NA,NA,NA,NA,NA,NA,NA,NA
"841","CO","504","Colorado Springs/El Paso County CoC",1249,891,358,253,247,6,82,80,2,2009,NA,NA,NA,NA,NA,NA,NA,NA
"842","CT","503","Bridgeport, Stamford, Norwalk/Fairfield County CoC",825,720,105,280,271,9,96,92,4,2009,NA,NA,NA,NA,NA,NA,NA,NA
"843","CT","505","Connecticut Balance of State CoC",3780,3383,397,1552,1544,8,528,525,3,2009,NA,NA,NA,NA,NA,NA,NA,NA
"844","DE","500","Delaware Statewide CoC",1130,1083,47,354,354,0,117,117,0,2009,NA,NA,NA,NA,NA,NA,NA,NA
"845","FL","500","Sarasota, Bradenton/Manatee, Sarasota Counties CoC",1999,348,1651,798,155,643,231,55,176,2009,NA,NA,NA,NA,NA,NA,NA,NA
"846","FL","501","Tampa/Hillsborough County CoC",7473,726,6747,3366,228,3138,1201,80,1121,2009,NA,NA,NA,NA,NA,NA,NA,NA
"847","FL","502","St. Petersburg, Clearwater, Largo/Pinellas County CoC",3419,1691,1728,576,439,137,226,169,57,2009,NA,NA,NA,NA,NA,NA,NA,NA
"848","FL","503","Lakeland, Winterhaven/Polk County CoC",725,366,359,119,88,31,35,26,9,2009,NA,NA,NA,NA,NA,NA,NA,NA
"849","FL","504","Daytona Beach, Daytona/Volusia, Flagler Counties CoC",1913,593,1320,406,406,0,95,95,0,2009,NA,NA,NA,NA,NA,NA,NA,NA
"850","FL","505","Fort Walton Beach/Okaloosa, Walton Counties CoC",2446,309,2137,931,87,844,368,31,337,2009,NA,NA,NA,NA,NA,NA,NA,NA
"851","FL","506","Tallahassee/Leon County CoC",640,536,104,165,138,27,48,40,8,2009,NA,NA,NA,NA,NA,NA,NA,NA
"852","FL","507","Orlando/Orange, Osceola, Seminole Counties CoC",3970,2454,1516,1724,1142,582,574,380,194,2009,NA,NA,NA,NA,NA,NA,NA,NA
"853","FL","508","Gainesville/Alachua, Putnam Counties CoC",924,301,623,174,125,49,63,48,15,2009,NA,NA,NA,NA,NA,NA,NA,NA
"854","FL","509","Fort Pierce/St. Lucie, Indian River, Martin Counties CoC",1950,289,1661,909,151,758,305,54,251,2009,NA,NA,NA,NA,NA,NA,NA,NA
"855","FL","510","Jacksonville-Duval, Clay Counties CoC",2442,2019,423,540,533,7,150,148,2,2009,NA,NA,NA,NA,NA,NA,NA,NA
"856","FL","511","Pensacola/Escambia, Santa Rosa Counties CoC",1030,412,618,345,154,191,148,41,107,2009,NA,NA,NA,NA,NA,NA,NA,NA
"857","FL","512","St. Johns County CoC",1237,106,1131,138,70,68,50,33,17,2009,NA,NA,NA,NA,NA,NA,NA,NA
"858","FL","513","Palm Bay, Melbourne/Brevard County CoC",1221,1002,219,340,331,9,109,106,3,2009,NA,NA,NA,NA,NA,NA,NA,NA
"859","FL","514","Ocala/Marion County CoC",491,297,194,173,77,96,47,23,24,2009,NA,NA,NA,NA,NA,NA,NA,NA
"860","FL","515","Panama City/Bay, Jackson Counties CoC",287,249,38,62,62,0,20,20,0,2009,NA,NA,NA,NA,NA,NA,NA,NA
"861","FL","517","Hendry, Hardee, Highlands Counties CoC",4220,101,4119,3408,38,3370,1619,14,1605,2009,NA,NA,NA,NA,NA,NA,NA,NA
"862","FL","518","Columbia, Hamilton, Lafayette, Suwannee Counties CoC",1114,165,949,390,80,310,159,35,124,2009,NA,NA,NA,NA,NA,NA,NA,NA
"863","FL","519","Pasco County CoC",4527,1674,2853,3215,1125,2090,1286,450,836,2009,NA,NA,NA,NA,NA,NA,NA,NA
"864","FL","520","Citrus, Hernando, Lake, Sumter Counties CoC",1025,236,789,454,44,410,132,15,117,2009,NA,NA,NA,NA,NA,NA,NA,NA
"865","FL","600","Miami-Dade County CoC",4333,3339,994,1310,1310,0,338,338,0,2009,NA,NA,NA,NA,NA,NA,NA,NA
"866","FL","601","Ft Lauderdale/Broward County CoC",3225,2425,800,650,586,64,206,189,17,2009,NA,NA,NA,NA,NA,NA,NA,NA
"867","FL","602","Punta Gorda/Charlotte County CoC",541,394,147,104,99,5,54,52,2,2009,NA,NA,NA,NA,NA,NA,NA,NA
"868","FL","603","Ft Myers, Cape Coral/Lee County CoC",931,515,416,107,71,36,38,23,15,2009,NA,NA,NA,NA,NA,NA,NA,NA
"869","FL","604","Monroe County CoC",1040,324,716,202,98,104,81,29,52,2009,NA,NA,NA,NA,NA,NA,NA,NA
"870","FL","605","West Palm Beach/Palm Beach County CoC",2147,740,1407,465,307,158,138,89,49,2009,NA,NA,NA,NA,NA,NA,NA,NA
"871","FL","606","Naples/Collier County CoC",329,256,73,96,96,0,30,30,0,2009,NA,NA,NA,NA,NA,NA,NA,NA
"872","GA","500","Atlanta CoC",7019,4855,2164,1238,1142,96,492,459,33,2009,NA,NA,NA,NA,NA,NA,NA,NA
"873","GA","501","Georgia Balance of State CoC",9941,2134,7807,3562,1431,2131,1086,440,646,2009,NA,NA,NA,NA,NA,NA,NA,NA
"874","GA","503","Athens-Clarke County CoC",454,248,206,130,102,28,42,31,11,2009,NA,NA,NA,NA,NA,NA,NA,NA
"875","GA","504","Augusta-Richmond County CoC",556,512,44,151,128,23,51,34,17,2009,NA,NA,NA,NA,NA,NA,NA,NA
"876","GA","505","Columbus-Muscogee/Russell County CoC",458,254,204,118,62,56,36,19,17,2009,NA,NA,NA,NA,NA,NA,NA,NA
"877","GA","506","Marietta/Cobb County CoC",480,354,126,213,210,3,75,74,1,2009,NA,NA,NA,NA,NA,NA,NA,NA
"878","GA","507","Savannah/Chatham County CoC",1452,1062,390,583,579,4,113,112,1,2009,NA,NA,NA,NA,NA,NA,NA,NA
"879","HI","500","Hawaii Balance of State CoC",2144,823,1321,1015,586,429,300,174,126,2009,NA,NA,NA,NA,NA,NA,NA,NA
"880","HI","501","Honolulu City and County CoC",3638,2445,1193,1826,1673,153,484,447,37,2009,NA,NA,NA,NA,NA,NA,NA,NA
"881","IA","500","Sioux City/Dakota, Woodbury Counties CoC",289,259,30,143,130,13,46,41,5,2009,NA,NA,NA,NA,NA,NA,NA,NA
"882","IA","501","Iowa Balance of State CoC",1962,1891,71,1191,1180,11,373,371,2,2009,NA,NA,NA,NA,NA,NA,NA,NA
"883","IA","502","Des Moines/Polk County CoC",1129,1071,58,391,387,4,113,111,2,2009,NA,NA,NA,NA,NA,NA,NA,NA
"884","ID","500","Boise/Ada County CoC",786,644,142,200,178,22,68,58,10,2009,NA,NA,NA,NA,NA,NA,NA,NA
"885","ID","501","Idaho Balance of State CoC",1153,833,320,622,478,144,212,162,50,2009,NA,NA,NA,NA,NA,NA,NA,NA
"886","IL","500","McHenry County CoC",257,247,10,104,104,0,33,33,0,2009,NA,NA,NA,NA,NA,NA,NA,NA
"887","IL","501","Rockford/Winnebago, Boone Counties CoC",452,347,105,114,84,30,24,18,6,2009,NA,NA,NA,NA,NA,NA,NA,NA
"888","IL","502","Waukegan, North Chicago/Lake County CoC",370,368,2,168,168,0,65,65,0,2009,NA,NA,NA,NA,NA,NA,NA,NA
"889","IL","503","Champaign, Urbana, Rantoul/Champaign County CoC",534,530,4,325,325,0,124,124,0,2009,NA,NA,NA,NA,NA,NA,NA,NA
"890","IL","504","Madison County CoC",202,161,41,140,130,10,42,39,3,2009,NA,NA,NA,NA,NA,NA,NA,NA
"891","IL","506","Joliet, Bolingbrook/Will County CoC",340,331,9,160,160,0,54,54,0,2009,NA,NA,NA,NA,NA,NA,NA,NA
"892","IL","507","Peoria, Pekin/Fulton, Tazewell, Peoria, Woodford Counties CoC",397,330,67,121,121,0,42,42,0,2009,NA,NA,NA,NA,NA,NA,NA,NA
"893","IL","508","East St. Louis, Belleville/St. Clair County CoC",536,242,294,275,196,79,92,58,34,2009,NA,NA,NA,NA,NA,NA,NA,NA
"894","IL","509","Dekalb City & County CoC",115,84,31,63,63,0,22,22,0,2009,NA,NA,NA,NA,NA,NA,NA,NA
"895","IL","510","Chicago CoC",6240,5356,884,2898,2808,90,883,861,22,2009,NA,NA,NA,NA,NA,NA,NA,NA
"896","IL","511","Cook County CoC",1378,1127,251,631,616,15,204,200,4,2009,NA,NA,NA,NA,NA,NA,NA,NA
"897","IL","512","Bloomington/Central Illinois CoC",515,482,33,301,292,9,88,85,3,2009,NA,NA,NA,NA,NA,NA,NA,NA
"898","IL","513","Springfield/Sangamon County CoC",257,248,9,105,98,7,36,35,1,2009,NA,NA,NA,NA,NA,NA,NA,NA
"899","IL","514","DuPage County CoC",695,587,108,345,336,9,121,118,3,2009,NA,NA,NA,NA,NA,NA,NA,NA
"900","IL","515","South Central Illinois CoC",329,234,95,277,202,75,87,65,22,2009,NA,NA,NA,NA,NA,NA,NA,NA
"901","IL","516","Decatur/Macon County CoC",176,150,26,66,66,0,19,19,0,2009,NA,NA,NA,NA,NA,NA,NA,NA
"902","IL","517","Aurora, Elgin/Kane County CoC",445,392,53,112,112,0,32,32,0,2009,NA,NA,NA,NA,NA,NA,NA,NA
"903","IL","518","Rock Island, Moline/Northwestern Illinois CoC",400,348,52,170,163,7,56,54,2,2009,NA,NA,NA,NA,NA,NA,NA,NA
"904","IL","519","West Central Illinois CoC",127,127,0,92,92,0,36,36,0,2009,NA,NA,NA,NA,NA,NA,NA,NA
"905","IL","520","Southern Illinois CoC",290,160,130,113,73,40,33,21,12,2009,NA,NA,NA,NA,NA,NA,NA,NA
"906","IN","502","Indiana Balance of State CoC",5530,3939,1591,2228,1920,308,762,661,101,2009,NA,NA,NA,NA,NA,NA,NA,NA
"907","IN","503","Indianapolis CoC",1454,1267,187,605,599,6,213,211,2,2009,NA,NA,NA,NA,NA,NA,NA,NA
"908","KS","502","Wichita/Sedgwick County CoC",384,352,32,74,74,0,25,25,0,2009,NA,NA,NA,NA,NA,NA,NA,NA
"909","KS","503","Topeka/Shawnee County CoC",217,198,19,78,78,0,24,24,0,2009,NA,NA,NA,NA,NA,NA,NA,NA
"910","KS","505","Overland Park, Shawnee/Johnson County CoC",210,166,44,152,121,31,48,38,10,2009,NA,NA,NA,NA,NA,NA,NA,NA
"911","KS","507","Kansas Balance of State CoC",859,800,59,266,253,13,85,81,4,2009,NA,NA,NA,NA,NA,NA,NA,NA
"912","KY","500","Kentucky Balance of State CoC",3174,2688,486,1895,1746,149,563,517,46,2009,NA,NA,NA,NA,NA,NA,NA,NA
"913","KY","501","Louisville-Jefferson County CoC",1515,1361,154,368,362,6,134,132,2,2009,NA,NA,NA,NA,NA,NA,NA,NA
"914","KY","502","Lexington-Fayette County CoC",1310,1250,60,434,426,8,161,158,3,2009,NA,NA,NA,NA,NA,NA,NA,NA
"915","LA","500","Lafayette/Acadiana CoC",731,538,193,348,271,77,114,92,22,2009,NA,NA,NA,NA,NA,NA,NA,NA
"916","LA","502","Shreveport, Bossier/Northwest Louisiana CoC",830,739,91,369,350,19,116,111,5,2009,NA,NA,NA,NA,NA,NA,NA,NA
"917","LA","503","New Orleans/Jefferson Parish CoC",8725,1340,7385,768,477,291,252,160,92,2009,NA,NA,NA,NA,NA,NA,NA,NA
"918","LA","505","Monroe/Northeast Louisiana CoC",228,187,41,135,118,17,38,33,5,2009,NA,NA,NA,NA,NA,NA,NA,NA
"919","LA","506","Slidell/Southeast Louisiana CoC",379,217,162,215,138,77,71,43,28,2009,NA,NA,NA,NA,NA,NA,NA,NA
"920","LA","507","Alexandria/Central Louisiana CoC",151,104,47,48,30,18,15,9,6,2009,NA,NA,NA,NA,NA,NA,NA,NA
"921","LA","509","Louisiana Balance of State CoC",1460,993,467,523,347,176,158,107,51,2009,NA,NA,NA,NA,NA,NA,NA,NA
"922","MA","500","Boston CoC",5101,4882,219,2438,2438,0,845,845,0,2009,NA,NA,NA,NA,NA,NA,NA,NA
"923","MA","501","Holyoke/Franklin, Hampden, Hampshire Counties CoC",1394,1336,58,912,912,0,265,265,0,2009,NA,NA,NA,NA,NA,NA,NA,NA
"924","MA","502","Lynn CoC",610,580,30,310,310,0,131,131,0,2009,NA,NA,NA,NA,NA,NA,NA,NA
"925","MA","503","Cape Cod Islands CoC",611,407,204,275,215,60,100,78,22,2009,NA,NA,NA,NA,NA,NA,NA,NA
"926","MA","504","Springfield/Hampden County CoC",774,762,12,467,467,0,175,175,0,2009,NA,NA,NA,NA,NA,NA,NA,NA
"927","MA","505","New Bedford CoC",510,408,102,101,97,4,45,44,1,2009,NA,NA,NA,NA,NA,NA,NA,NA
"928","MA","506","Worcester City & County CoC",1397,1361,36,879,873,6,316,314,2,2009,NA,NA,NA,NA,NA,NA,NA,NA
"929","MA","507","Pittsfield/Berkshire, Franklin, Hampshire Counties CoC",286,191,95,82,29,53,40,14,26,2009,NA,NA,NA,NA,NA,NA,NA,NA
"930","MA","508","Lowell CoC",309,298,11,146,146,0,56,56,0,2009,NA,NA,NA,NA,NA,NA,NA,NA
"931","MA","509","Cambridge CoC",637,594,43,334,334,0,129,129,0,2009,NA,NA,NA,NA,NA,NA,NA,NA
"932","MA","510","Gloucester, Haverhill, Salem/Essex County CoC",813,744,69,407,407,0,109,109,0,2009,NA,NA,NA,NA,NA,NA,NA,NA
"933","MA","511","Quincy, Brockton, Weymouth, Plymouth City and County CoC",1263,1217,46,896,896,0,320,320,0,2009,NA,NA,NA,NA,NA,NA,NA,NA
"934","MA","515","Fall River CoC",154,144,10,50,50,0,22,22,0,2009,NA,NA,NA,NA,NA,NA,NA,NA
"935","MA","516","Massachusetts Balance of State CoC",1349,1311,38,992,992,0,425,425,0,2009,NA,NA,NA,NA,NA,NA,NA,NA
"936","MA","517","Somerville CoC",132,128,4,62,62,0,27,27,0,2009,NA,NA,NA,NA,NA,NA,NA,NA
"937","MA","519","Attleboro, Taunton/Bristol County CoC",142,113,29,74,74,0,30,30,0,2009,NA,NA,NA,NA,NA,NA,NA,NA
"938","MD","500","Cumberland/Allegany County CoC",218,203,15,142,139,3,37,36,1,2009,NA,NA,NA,NA,NA,NA,NA,NA
"939","MD","501","Baltimore CoC",3419,2191,1228,935,444,491,359,163,196,2009,NA,NA,NA,NA,NA,NA,NA,NA
"940","MD","502","Harford County CoC",152,128,24,66,66,0,22,22,0,2009,NA,NA,NA,NA,NA,NA,NA,NA
"941","MD","503","Annapolis/Anne Arundel County CoC",326,232,94,128,128,0,41,41,0,2009,NA,NA,NA,NA,NA,NA,NA,NA
"942","MD","504","Howard County CoC",180,133,47,92,90,2,30,29,1,2009,NA,NA,NA,NA,NA,NA,NA,NA
"943","MD","505","Baltimore County CoC",1520,1114,406,341,277,64,131,106,25,2009,NA,NA,NA,NA,NA,NA,NA,NA
"944","MD","506","Carroll County CoC",151,123,28,35,25,10,12,8,4,2009,NA,NA,NA,NA,NA,NA,NA,NA
"945","MD","507","Cecil County CoC",173,146,27,83,77,6,36,34,2,2009,NA,NA,NA,NA,NA,NA,NA,NA
"946","MD","508","Charles, Calvert, St.Mary's Counties CoC",2560,536,2024,1920,312,1608,594,94,500,2009,NA,NA,NA,NA,NA,NA,NA,NA
"947","MD","509","Frederick City & County CoC",324,257,67,138,108,30,46,36,10,2009,NA,NA,NA,NA,NA,NA,NA,NA
"948","MD","510","Garrett County CoC",11,4,7,0,0,0,0,0,0,2009,NA,NA,NA,NA,NA,NA,NA,NA
"949","MD","511","Mid-Shore Regional CoC",144,138,6,59,59,0,16,16,0,2009,NA,NA,NA,NA,NA,NA,NA,NA
"950","MD","512","Hagerstown/Washington County CoC",137,110,27,77,57,20,28,21,7,2009,NA,NA,NA,NA,NA,NA,NA,NA
"951","MD","513","Wicomico, Somerset, Worcester Counties CoC",283,240,43,81,81,0,34,34,0,2009,NA,NA,NA,NA,NA,NA,NA,NA
"952","MD","600","Prince George's County CoC",853,771,82,434,434,0,121,121,0,2009,NA,NA,NA,NA,NA,NA,NA,NA
"953","MD","601","Montgomery County CoC",1247,1120,127,526,526,0,168,168,0,2009,NA,NA,NA,NA,NA,NA,NA,NA
"954","ME","500","Maine Statewide CoC",2444,2406,38,1320,1314,6,445,443,2,2009,NA,NA,NA,NA,NA,NA,NA,NA
"955","MI","500","Michigan Balance of State CoC",2953,2031,922,1802,1415,387,619,492,127,2009,NA,NA,NA,NA,NA,NA,NA,NA
"956","MI","501","Detroit CoC",3694,3432,262,725,725,0,230,230,0,2009,NA,NA,NA,NA,NA,NA,NA,NA
"957","MI","502","Dearborn, Dearborn Heights, Westland/Wayne County CoC",428,422,6,269,269,0,68,68,0,2009,NA,NA,NA,NA,NA,NA,NA,NA
"958","MI","503","St. Clair Shores, Warren/Macomb County CoC",877,292,585,288,42,246,86,15,71,2009,NA,NA,NA,NA,NA,NA,NA,NA
"959","MI","504","Pontiac, Royal Oak/Oakland County CoC",661,381,280,242,204,38,78,66,12,2009,NA,NA,NA,NA,NA,NA,NA,NA
"960","MI","505","Flint/Genesee County CoC",275,193,82,121,99,22,39,31,8,2009,NA,NA,NA,NA,NA,NA,NA,NA
"961","MI","506","Grand Rapids, Wyoming/Kent County CoC",868,834,34,478,468,10,172,167,5,2009,NA,NA,NA,NA,NA,NA,NA,NA
"962","MI","507","Portage, Kalamazoo City & County CoC",985,971,14,559,559,0,166,166,0,2009,NA,NA,NA,NA,NA,NA,NA,NA
"963","MI","508","Lansing, East Lansing/Ingham County CoC",416,396,20,191,191,0,61,61,0,2009,NA,NA,NA,NA,NA,NA,NA,NA
"964","MI","509","Washtenaw County CoC",342,307,35,132,130,2,37,36,1,2009,NA,NA,NA,NA,NA,NA,NA,NA
"965","MI","510","Saginaw City & County CoC",305,278,27,129,129,0,43,43,0,2009,NA,NA,NA,NA,NA,NA,NA,NA
"966","MI","511","Lenawee County CoC",114,109,5,85,82,3,26,25,1,2009,NA,NA,NA,NA,NA,NA,NA,NA
"967","MI","512","Grand Traverse, Antrim, Leelanau Counties CoC",281,279,2,148,148,0,62,62,0,2009,NA,NA,NA,NA,NA,NA,NA,NA
"968","MI","513","Marquette, Alger Counties CoC",68,63,5,40,40,0,14,14,0,2009,NA,NA,NA,NA,NA,NA,NA,NA
"969","MI","514","Battle Creek/Calhoun County CoC",238,185,53,62,57,5,21,20,1,2009,NA,NA,NA,NA,NA,NA,NA,NA
"970","MI","515","Monroe City & County CoC",140,136,4,65,62,3,30,29,1,2009,NA,NA,NA,NA,NA,NA,NA,NA
"971","MI","516","Norton Shores, Muskegon City & County CoC",466,145,321,212,67,145,79,20,59,2009,NA,NA,NA,NA,NA,NA,NA,NA
"972","MI","517","Jackson City & County CoC",323,304,19,202,202,0,64,64,0,2009,NA,NA,NA,NA,NA,NA,NA,NA
"973","MI","518","Livingston County CoC",121,108,13,75,75,0,23,23,0,2009,NA,NA,NA,NA,NA,NA,NA,NA
"974","MI","519","Holland/Ottawa County CoC",299,297,2,186,186,0,56,56,0,2009,NA,NA,NA,NA,NA,NA,NA,NA
"975","MI","523","Eaton County CoC",151,135,16,137,129,8,38,35,3,2009,NA,NA,NA,NA,NA,NA,NA,NA
"976","MN","500","Minneapolis/Hennepin County CoC",3281,3025,256,1730,1699,31,495,486,9,2009,NA,NA,NA,NA,NA,NA,NA,NA
"977","MN","501","Saint Paul/Ramsey County CoC",1377,1284,93,684,680,4,239,238,1,2009,NA,NA,NA,NA,NA,NA,NA,NA
"978","MN","502","Rochester/Southeast Minnesota CoC",417,413,4,293,293,0,97,97,0,2009,NA,NA,NA,NA,NA,NA,NA,NA
"979","MN","503","Dakota, Anoka, Washington, Scott, Carver Counties",840,733,107,644,602,42,207,192,15,2009,NA,NA,NA,NA,NA,NA,NA,NA
"980","MN","504","Northeast Minnesota CoC",210,120,90,141,93,48,45,32,13,2009,NA,NA,NA,NA,NA,NA,NA,NA
"981","MN","505","St. Cloud/Central Minnesota CoC",451,343,108,223,190,33,72,66,6,2009,NA,NA,NA,NA,NA,NA,NA,NA
"982","MN","506","Northwest Minnesota CoC",261,225,36,174,162,12,54,48,6,2009,NA,NA,NA,NA,NA,NA,NA,NA
"983","MN","508","Moorhead/West Central Minnesota CoC",272,192,80,146,124,22,45,39,6,2009,NA,NA,NA,NA,NA,NA,NA,NA
"984","MN","509","Duluth/St.Louis County CoC",504,356,148,242,227,15,93,89,4,2009,NA,NA,NA,NA,NA,NA,NA,NA
"985","MN","511","Southwest Minnesota CoC",105,81,24,48,34,14,15,11,4,2009,NA,NA,NA,NA,NA,NA,NA,NA
"986","MO","500","St. Louis County CoC",643,414,229,422,283,139,132,95,37,2009,NA,NA,NA,NA,NA,NA,NA,NA
"987","MO","501","St.Louis City CoC",1306,973,333,464,362,102,161,132,29,2009,NA,NA,NA,NA,NA,NA,NA,NA
"988","MO","503","St. Charles City & County, Lincoln, Warren Counties CoC",830,549,281,492,341,151,175,127,48,2009,NA,NA,NA,NA,NA,NA,NA,NA
"989","MO","600","Springfield/Greene, Christian, Webster Counties CoC",418,383,35,217,206,11,71,66,5,2009,NA,NA,NA,NA,NA,NA,NA,NA
"990","MO","602","Joplin/Jasper, Newton Counties CoC",322,285,37,61,61,0,21,21,0,2009,NA,NA,NA,NA,NA,NA,NA,NA
"991","MO","603","St. Joseph/Andrew, Buchanan, DeKalb Counties CoC",159,155,4,63,63,0,23,23,0,2009,NA,NA,NA,NA,NA,NA,NA,NA
"992","MO","604a","Kansas City, Independence, Lee’s Summit/Jackson, Wyandotte Counties, MO & KS",1809,1570,239,693,655,38,215,203,12,2009,NA,NA,NA,NA,NA,NA,NA,NA
"993","MO","606","Missouri Balance of State CoC",1694,1320,374,808,649,159,256,208,48,2009,NA,NA,NA,NA,NA,NA,NA,NA
"994","MS","500","Jackson/Rankin, Madison Counties CoC",922,426,496,229,130,99,73,43,30,2009,NA,NA,NA,NA,NA,NA,NA,NA
"995","MS","501","Mississippi Balance of State CoC",1242,660,582,661,383,278,199,106,93,2009,NA,NA,NA,NA,NA,NA,NA,NA
"996","MS","503","Gulf Port/Gulf Coast Regional CoC",633,135,498,64,53,11,29,24,5,2009,NA,NA,NA,NA,NA,NA,NA,NA
"997","MT","500","Montana Statewide CoC",1196,833,363,444,352,92,133,111,22,2009,NA,NA,NA,NA,NA,NA,NA,NA
"998","NC","500","Winston-Salem/Forsyth County CoC",489,421,68,94,94,0,33,33,0,2009,NA,NA,NA,NA,NA,NA,NA,NA
"999","NC","501","Asheville/Buncombe County CoC",518,426,92,86,86,0,35,35,0,2009,NA,NA,NA,NA,NA,NA,NA,NA
"1000","NC","502","Durham City & County CoC",536,502,34,99,99,0,34,34,0,2009,NA,NA,NA,NA,NA,NA,NA,NA
"1001","NC","503","North Carolina Balance of State CoC",2821,2009,812,961,783,178,328,262,66,2009,NA,NA,NA,NA,NA,NA,NA,NA
"1002","NC","504","Greensboro, High Point CoC",1078,948,130,332,320,12,99,96,3,2009,NA,NA,NA,NA,NA,NA,NA,NA
"1003","NC","505","Charlotte/Mecklenberg CoC",2594,2044,550,664,661,3,176,175,1,2009,NA,NA,NA,NA,NA,NA,NA,NA
"1004","NC","506","Wilmington/Brunswick, New Hanover, Pender Counties CoC",630,468,162,287,219,68,107,79,28,2009,NA,NA,NA,NA,NA,NA,NA,NA
"1005","NC","507","Raleigh/Wake County CoC",1152,905,247,271,271,0,79,79,0,2009,NA,NA,NA,NA,NA,NA,NA,NA
"1006","NC","509","Gastonia/Cleveland, Gaston, Lincoln Counties CoC",580,224,356,153,78,75,51,27,24,2009,NA,NA,NA,NA,NA,NA,NA,NA
"1007","NC","511","Fayetteville/Cumberland County CoC",965,263,702,554,187,367,145,52,93,2009,NA,NA,NA,NA,NA,NA,NA,NA
"1008","NC","513","Chapel Hill/Orange County CoC",156,151,5,46,46,0,19,19,0,2009,NA,NA,NA,NA,NA,NA,NA,NA
"1009","NC","516","Northwest North Carolina CoC",1399,112,1287,212,53,159,78,19,59,2009,NA,NA,NA,NA,NA,NA,NA,NA
"1010","ND","500","North Dakota Statewide CoC",773,765,8,225,225,0,72,72,0,2009,NA,NA,NA,NA,NA,NA,NA,NA
"1011","NE","500","Nebraska Balance of State CoC",1483,931,552,821,510,311,252,156,96,2009,NA,NA,NA,NA,NA,NA,NA,NA
"1012","NE","501","Omaha, Council Bluffs CoC",1262,1201,61,304,304,0,98,98,0,2009,NA,NA,NA,NA,NA,NA,NA,NA
"1013","NE","502","Lincoln CoC",973,947,26,521,518,3,180,179,1,2009,NA,NA,NA,NA,NA,NA,NA,NA
"1014","NH","500","New Hampshire Balance of State CoC",769,719,50,372,364,8,122,119,3,2009,NA,NA,NA,NA,NA,NA,NA,NA
"1015","NH","501","Manchester CoC",508,337,171,192,185,7,73,71,2,2009,NA,NA,NA,NA,NA,NA,NA,NA
"1016","NH","502","Nashua/Hillsborough County CoC",368,350,18,190,187,3,64,63,1,2009,NA,NA,NA,NA,NA,NA,NA,NA
"1017","NJ","500","Atlantic City & County CoC",461,339,122,146,121,25,52,42,10,2009,NA,NA,NA,NA,NA,NA,NA,NA
"1018","NJ","501","Bergen County CoC",1433,1354,79,861,841,20,313,305,8,2009,NA,NA,NA,NA,NA,NA,NA,NA
"1019","NJ","502","Burlington County CoC",979,949,30,597,591,6,182,179,3,2009,NA,NA,NA,NA,NA,NA,NA,NA
"1020","NJ","503","Camden City & County/Gloucester, Cape May, Cumberland Counties CoC",1116,922,194,513,450,63,176,154,22,2009,NA,NA,NA,NA,NA,NA,NA,NA
"1021","NJ","504","Newark/Essex County CoC",1730,1539,191,966,924,42,307,293,14,2009,NA,NA,NA,NA,NA,NA,NA,NA
"1022","NJ","506","Jersey City, Bayonne/Hudson County CoC",1779,1650,129,1216,1183,33,448,437,11,2009,NA,NA,NA,NA,NA,NA,NA,NA
"1023","NJ","507","New Brunswick/Middlesex County CoC",796,583,213,364,298,66,133,107,26,2009,NA,NA,NA,NA,NA,NA,NA,NA
"1024","NJ","508","Monmouth County CoC",676,638,38,376,361,15,134,129,5,2009,NA,NA,NA,NA,NA,NA,NA,NA
"1025","NJ","509","Morris County CoC",302,257,45,151,149,2,55,54,1,2009,NA,NA,NA,NA,NA,NA,NA,NA
"1026","NJ","510","Lakewood Township/Ocean County CoC",453,406,47,200,193,7,67,64,3,2009,NA,NA,NA,NA,NA,NA,NA,NA
"1027","NJ","511","Paterson/Passaic County CoC",306,207,99,127,95,32,41,30,11,2009,NA,NA,NA,NA,NA,NA,NA,NA
"1028","NJ","512","Salem County CoC",148,146,2,63,63,0,22,22,0,2009,NA,NA,NA,NA,NA,NA,NA,NA
"1029","NJ","513","Somerset County CoC",298,283,15,121,118,3,32,31,1,2009,NA,NA,NA,NA,NA,NA,NA,NA
"1030","NJ","514","Trenton/Mercer County CoC",1062,1020,42,547,534,13,197,191,6,2009,NA,NA,NA,NA,NA,NA,NA,NA
"1031","NJ","515","Elizabeth/Union County CoC",1116,1077,39,626,618,8,221,219,2,2009,NA,NA,NA,NA,NA,NA,NA,NA
"1032","NJ","516","Warren, Sussex, Hunterdon Counties CoC",514,501,13,333,327,6,118,117,1,2009,NA,NA,NA,NA,NA,NA,NA,NA
"1033","NM","500","Albuquerque CoC",2002,1071,931,548,454,94,180,141,39,2009,NA,NA,NA,NA,NA,NA,NA,NA
"1034","NM","501","New Mexico Balance of State CoC",1473,1037,436,584,552,32,124,111,13,2009,NA,NA,NA,NA,NA,NA,NA,NA
"1035","NV","500","Las Vegas/Clark County CoC",9949,7004,2945,1383,1370,13,342,338,4,2009,NA,NA,NA,NA,NA,NA,NA,NA
"1036","NV","501","Reno, Sparks/Washoe County CoC",700,645,55,178,174,4,53,52,1,2009,NA,NA,NA,NA,NA,NA,NA,NA
"1037","NV","502","Nevada Balance of State CoC",440,143,297,134,105,29,43,34,9,2009,NA,NA,NA,NA,NA,NA,NA,NA
"1038","NY","500","Rochester, Irondequoit, Greece/Monroe County CoC",663,663,0,323,323,0,104,104,0,2009,NA,NA,NA,NA,NA,NA,NA,NA
"1039","NY","501","Elmira/Steuben, Allegany, Livingston, Chemung, Schuyler Counties CoC",184,178,6,39,36,3,14,13,1,2009,NA,NA,NA,NA,NA,NA,NA,NA
"1040","NY","503","Albany City & County CoC",639,604,35,210,210,0,68,68,0,2009,NA,NA,NA,NA,NA,NA,NA,NA
"1041","NY","504","Cattaragus County CoC",74,57,17,27,27,0,10,10,0,2009,NA,NA,NA,NA,NA,NA,NA,NA
"1042","NY","505","Syracuse, Auburn/Onondaga, Oswego, Cayuga Counties CoC",874,842,32,174,170,4,56,54,2,2009,NA,NA,NA,NA,NA,NA,NA,NA
"1043","NY","506","Fulton, Montgomery, Schoharie Counties CoC",24,20,4,9,9,0,3,3,0,2009,NA,NA,NA,NA,NA,NA,NA,NA
"1044","NY","507","Schenectady City & County CoC",258,196,62,80,74,6,31,28,3,2009,NA,NA,NA,NA,NA,NA,NA,NA
"1045","NY","508","Buffalo, Niagara Falls/Erie, Niagara, Orleans, Genesee, Wyoming Counties CoC",1069,940,129,268,265,3,99,98,1,2009,NA,NA,NA,NA,NA,NA,NA,NA
"1046","NY","510","Ithaca/Tompkins County CoC",75,65,10,30,30,0,9,9,0,2009,NA,NA,NA,NA,NA,NA,NA,NA
"1047","NY","511","Binghamton, Union Town/Broome, Otsego, Chenango, Delaware, Cortland, Tioga Count",213,202,11,18,18,0,7,7,0,2009,NA,NA,NA,NA,NA,NA,NA,NA
"1048","NY","512","Troy/Rensselaer County CoC",298,260,38,223,223,0,82,82,0,2009,NA,NA,NA,NA,NA,NA,NA,NA
"1049","NY","513","Wayne, Ontario, Seneca, Yates Counties CoC",81,81,0,38,38,0,15,15,0,2009,NA,NA,NA,NA,NA,NA,NA,NA
"1050","NY","514","Jamestown, Dunkirk/Chautauqua County CoC",128,123,5,43,43,0,21,21,0,2009,NA,NA,NA,NA,NA,NA,NA,NA
"1051","NY","516","Clinton County CoC",136,124,12,29,29,0,13,13,0,2009,NA,NA,NA,NA,NA,NA,NA,NA
"1052","NY","518","Utica, Rome/Oneida, Madison Counties CoC",343,326,17,92,92,0,32,32,0,2009,NA,NA,NA,NA,NA,NA,NA,NA
"1053","NY","519","Columbia, Greene Counties CoC",267,260,7,122,122,0,38,38,0,2009,NA,NA,NA,NA,NA,NA,NA,NA
"1054","NY","520","Franklin, Essex Counties CoC",14,5,9,6,0,6,3,0,3,2009,NA,NA,NA,NA,NA,NA,NA,NA
"1055","NY","522","Jefferson, Lewis, St. Lawrence Counties CoC",276,275,1,32,32,0,11,11,0,2009,NA,NA,NA,NA,NA,NA,NA,NA
"1056","NY","523","Glens Falls, Saratoga Springs/Saratoga, Washington, Warren, Hamilton Counties Co",195,164,31,50,47,3,19,18,1,2009,NA,NA,NA,NA,NA,NA,NA,NA
"1057","NY","600","New York City CoC",49343,47015,2328,31155,31155,0,9633,9633,0,2009,NA,NA,NA,NA,NA,NA,NA,NA
"1058","NY","601","Poughkeepsie/Dutchess County CoC",474,404,70,190,190,0,73,73,0,2009,NA,NA,NA,NA,NA,NA,NA,NA
"1059","NY","602","Newburgh, Middletown/Orange County CoC",450,345,105,176,176,0,61,61,0,2009,NA,NA,NA,NA,NA,NA,NA,NA
"1060","NY","603","Nassau, Suffolk Counties CoC",2639,2330,309,1822,1808,14,542,535,7,2009,NA,NA,NA,NA,NA,NA,NA,NA
"1061","NY","604","Yonkers, Mount Vernon/Westchester County CoC",1531,1365,166,976,976,0,331,331,0,2009,NA,NA,NA,NA,NA,NA,NA,NA
"1062","NY","606","Rockland County CoC",139,77,62,37,37,0,13,13,0,2009,NA,NA,NA,NA,NA,NA,NA,NA
"1063","NY","607","Sullivan County CoC",369,366,3,245,245,0,76,76,0,2009,NA,NA,NA,NA,NA,NA,NA,NA
"1064","NY","608","Kingston/Ulster County CoC",311,167,144,96,74,22,38,31,7,2009,NA,NA,NA,NA,NA,NA,NA,NA
"1065","OH","500","Cincinnati/Hamilton County CoC",1140,1097,43,359,359,0,114,114,0,2009,NA,NA,NA,NA,NA,NA,NA,NA
"1066","OH","501","Toledo/Lucas County CoC",945,727,218,348,277,71,120,102,18,2009,NA,NA,NA,NA,NA,NA,NA,NA
"1067","OH","502","Cleveland/Cuyahoga County CoC",2236,2105,131,493,488,5,162,161,1,2009,NA,NA,NA,NA,NA,NA,NA,NA
"1068","OH","503","Columbus/Franklin County CoC",1359,1251,108,387,381,6,119,118,1,2009,NA,NA,NA,NA,NA,NA,NA,NA
"1069","OH","504","Youngstown/Mahoning County CoC",183,177,6,100,100,0,31,31,0,2009,NA,NA,NA,NA,NA,NA,NA,NA
"1070","OH","505","Dayton, Kettering/Montgomery County CoC",837,823,14,335,335,0,112,112,0,2009,NA,NA,NA,NA,NA,NA,NA,NA
"1071","OH","506","Akron, Barberton/Summit County CoC",820,658,162,271,251,20,93,83,10,2009,NA,NA,NA,NA,NA,NA,NA,NA
"1072","OH","507","Ohio Balance of State CoC",4770,3758,1012,2446,2129,317,844,749,95,2009,NA,NA,NA,NA,NA,NA,NA,NA
"1073","OH","508","Canton, Massillon, Alliance/Stark County CoC",410,333,77,187,179,8,53,50,3,2009,NA,NA,NA,NA,NA,NA,NA,NA
"1074","OK","500","North Central Oklahoma CoC",316,172,144,160,111,49,61,45,16,2009,NA,NA,NA,NA,NA,NA,NA,NA
"1075","OK","501","Tulsa City & County CoC",826,797,29,180,180,0,59,59,0,2009,NA,NA,NA,NA,NA,NA,NA,NA
"1076","OK","502","Oklahoma City CoC",1475,1103,372,267,261,6,95,93,2,2009,NA,NA,NA,NA,NA,NA,NA,NA
"1077","OK","503","Oklahoma Balance of State CoC",340,289,51,133,114,19,56,52,4,2009,NA,NA,NA,NA,NA,NA,NA,NA
"1078","OK","504","Norman/Cleveland County CoC",585,289,296,215,115,100,69,39,30,2009,NA,NA,NA,NA,NA,NA,NA,NA
"1079","OK","505","Northeast Oklahoma CoC",635,264,371,307,148,159,103,50,53,2009,NA,NA,NA,NA,NA,NA,NA,NA
"1080","OK","506","Southwest Oklahoma Regional CoC",272,252,20,116,113,3,30,29,1,2009,NA,NA,NA,NA,NA,NA,NA,NA
"1081","OK","507","Southeastern Oklahoma Regional CoC",389,141,248,233,80,153,72,25,47,2009,NA,NA,NA,NA,NA,NA,NA,NA
"1082","OR","500","Eugene, Springfield/Lane County CoC",2232,999,1233,726,482,244,237,157,80,2009,NA,NA,NA,NA,NA,NA,NA,NA
"1083","OR","501","Portland, Gresham/Multnomah County CoC",4085,2494,1591,1140,1062,78,391,356,35,2009,NA,NA,NA,NA,NA,NA,NA,NA
"1084","OR","502","Medford, Ashland/Jackson County CoC",899,854,45,143,137,6,57,55,2,2009,NA,NA,NA,NA,NA,NA,NA,NA
"1085","OR","503","Central Oregon CoC",742,310,432,352,170,182,106,54,52,2009,NA,NA,NA,NA,NA,NA,NA,NA
"1086","OR","505","Oregon Balance of State CoC",6777,2446,4331,3668,1324,2344,1197,432,765,2009,NA,NA,NA,NA,NA,NA,NA,NA
"1087","OR","506","Hillsboro, Beaverton/Washington County CoC",748,212,536,375,166,209,117,52,65,2009,NA,NA,NA,NA,NA,NA,NA,NA
"1088","OR","507","Clackamas County CoC",1826,127,1699,462,109,353,128,32,96,2009,NA,NA,NA,NA,NA,NA,NA,NA
"1089","PA","500","Philadelphia CoC",6304,5798,506,3250,3250,0,1020,1020,0,2009,NA,NA,NA,NA,NA,NA,NA,NA
"1090","PA","501","Harrisburg/Dauphin County CoC",421,365,56,180,180,0,64,64,0,2009,NA,NA,NA,NA,NA,NA,NA,NA
"1091","PA","502","Upper Darby, Chester, Haverford/Delaware County CoC",778,727,51,506,506,0,134,134,0,2009,NA,NA,NA,NA,NA,NA,NA,NA
"1092","PA","503","Wilkes-Barre, Hazleton/Luzerne County CoC",202,199,3,71,71,0,25,25,0,2009,NA,NA,NA,NA,NA,NA,NA,NA
"1093","PA","504","Lower Merion, Norristown, Abington/Montgomery County CoC",469,431,38,288,283,5,108,106,2,2009,NA,NA,NA,NA,NA,NA,NA,NA
"1094","PA","505","Chester County CoC",351,334,17,171,171,0,54,54,0,2009,NA,NA,NA,NA,NA,NA,NA,NA
"1095","PA","506","Reading/Berks County CoC",385,378,7,162,162,0,57,57,0,2009,NA,NA,NA,NA,NA,NA,NA,NA
"1096","PA","508","Scranton/Lackawanna County CoC",280,228,52,162,138,24,58,47,11,2009,NA,NA,NA,NA,NA,NA,NA,NA
"1097","PA","509","Eastern Pennsylvania CoC",1908,1771,137,1117,1109,8,368,366,2,2009,NA,NA,NA,NA,NA,NA,NA,NA
"1098","PA","510","Lancaster City & County CoC",666,649,17,286,283,3,104,103,1,2009,NA,NA,NA,NA,NA,NA,NA,NA
"1099","PA","511","Bristol, Bensalem/Bucks County CoC",474,440,34,304,296,8,86,85,1,2009,NA,NA,NA,NA,NA,NA,NA,NA
"1100","PA","600","Pittsburgh, McKeesport, Penn Hills/Allegheny County CoC",1418,1136,282,511,511,0,181,181,0,2009,NA,NA,NA,NA,NA,NA,NA,NA
"1101","PA","601","Western Pennsylvania CoC",831,811,20,404,404,0,139,139,0,2009,NA,NA,NA,NA,NA,NA,NA,NA
"1102","PA","603","Beaver County CoC",220,202,18,87,81,6,26,24,2,2009,NA,NA,NA,NA,NA,NA,NA,NA
"1103","PA","605","Erie City & County CoC",389,350,39,213,183,30,73,61,12,2009,NA,NA,NA,NA,NA,NA,NA,NA
"1104","RI","500","Rhode Island Statewide CoC",1607,1556,51,468,468,0,202,202,0,2009,NA,NA,NA,NA,NA,NA,NA,NA
"1105","SC","500","Charleston/Low Country CoC",416,347,69,79,79,0,27,27,0,2009,NA,NA,NA,NA,NA,NA,NA,NA
"1106","SC","501","Greenville, Anderson, Spartanburg/Upstate CoC",1164,1008,156,411,408,3,131,130,1,2009,NA,NA,NA,NA,NA,NA,NA,NA
"1107","SC","502","Columbia/Midlands CoC",1368,929,439,375,317,58,131,111,20,2009,NA,NA,NA,NA,NA,NA,NA,NA
"1108","SC","503","Myrtle Beach, Sumter City & County CoC",1525,752,773,414,287,127,185,135,50,2009,NA,NA,NA,NA,NA,NA,NA,NA
"1109","SD","500","South Dakota Statewide CoC",731,667,64,286,286,0,87,87,0,2009,NA,NA,NA,NA,NA,NA,NA,NA
"1110","TN","500","Chattanooga/Southeast Tennessee CoC",513,306,207,150,104,46,47,33,14,2009,NA,NA,NA,NA,NA,NA,NA,NA
"1111","TN","501","Memphis/Shelby County CoC",1613,1544,69,635,635,0,192,192,0,2009,NA,NA,NA,NA,NA,NA,NA,NA
"1112","TN","502","Knoxville/Knox County CoC",959,842,117,134,125,9,45,42,3,2009,NA,NA,NA,NA,NA,NA,NA,NA
"1113","TN","503","Central Tennessee CoC",226,181,45,55,53,2,20,19,1,2009,NA,NA,NA,NA,NA,NA,NA,NA
"1114","TN","504","Nashville-Davidson County CoC",2236,1838,398,219,219,0,96,96,0,2009,NA,NA,NA,NA,NA,NA,NA,NA
"1115","TN","506","Upper Cumberland CoC",1229,196,1033,638,41,597,297,11,286,2009,NA,NA,NA,NA,NA,NA,NA,NA
"1116","TN","507","Jackson/West Tennessee CoC",2214,1126,1088,192,87,105,71,26,45,2009,NA,NA,NA,NA,NA,NA,NA,NA
"1117","TN","509","Appalachian Regional CoC",840,641,199,97,83,14,30,27,3,2009,NA,NA,NA,NA,NA,NA,NA,NA
"1118","TN","510","Murfreesboro/Rutherford County CoC",204,112,92,44,44,0,14,14,0,2009,NA,NA,NA,NA,NA,NA,NA,NA
"1119","TN","512","Morristown/Blount, Sevier, Campbell, Cocke Counties CoC",498,347,151,320,222,98,155,127,28,2009,NA,NA,NA,NA,NA,NA,NA,NA
"1120","TX","500","San Antonio/Bexar County CoC",2690,1583,1107,784,753,31,256,247,9,2009,NA,NA,NA,NA,NA,NA,NA,NA
"1121","TX","503","Austin/Travis County CoC",2641,1418,1223,663,640,23,215,208,7,2009,NA,NA,NA,NA,NA,NA,NA,NA
"1122","TX","600","Dallas City & County, Irving CoC",3701,3525,176,1476,1464,12,452,449,3,2009,NA,NA,NA,NA,NA,NA,NA,NA
"1123","TX","601","Fort Worth, Arlington/Tarrant County CoC",2181,1986,195,882,882,0,281,281,0,2009,NA,NA,NA,NA,NA,NA,NA,NA
"1124","TX","603","El Paso City & County CoC",1260,964,296,492,486,6,159,156,3,2009,NA,NA,NA,NA,NA,NA,NA,NA
"1125","TX","604","Waco/McLennan County CoC",312,226,86,81,75,6,24,23,1,2009,NA,NA,NA,NA,NA,NA,NA,NA
"1126","TX","607","Texas Balance of State CoC",15327,5644,9683,7845,2736,5109,3234,994,2240,2009,NA,NA,NA,NA,NA,NA,NA,NA
"1127","TX","611","Amarillo CoC",566,439,127,231,197,34,71,55,16,2009,NA,NA,NA,NA,NA,NA,NA,NA
"1128","TX","624","Wichita Falls/Wise, Palo Pinto, Wichita, Archer Counties CoC",242,235,7,27,27,0,11,11,0,2009,NA,NA,NA,NA,NA,NA,NA,NA
"1129","TX","700","Houston, Pasadena, Conroe/Harris, Ft. Bend, Montgomery, Counties CoC",7576,5457,2119,1674,1420,254,561,497,64,2009,NA,NA,NA,NA,NA,NA,NA,NA
"1130","TX","701","Bryan, College Station/Brazos Valley CoC",265,181,84,42,35,7,18,15,3,2009,NA,NA,NA,NA,NA,NA,NA,NA
"1131","UT","500","Salt Lake City & County CoC",1811,1699,112,761,761,0,288,288,0,2009,NA,NA,NA,NA,NA,NA,NA,NA
"1132","UT","503","Utah Balance of State CoC",1685,1586,99,670,670,0,208,208,0,2009,NA,NA,NA,NA,NA,NA,NA,NA
"1133","UT","504","Provo/Mountainland CoC",299,255,44,122,122,0,41,41,0,2009,NA,NA,NA,NA,NA,NA,NA,NA
"1134","VA","500","Richmond/Henrico, Chesterfield, Hanover Counties CoC",1150,1078,72,224,224,0,84,84,0,2009,NA,NA,NA,NA,NA,NA,NA,NA
"1135","VA","501","Norfolk/Chesapeake, Suffolk, Isle of Wight, Southampton Counties CoC",685,553,132,215,192,23,69,61,8,2009,NA,NA,NA,NA,NA,NA,NA,NA
"1136","VA","502","Roanoke City & County, Salem CoC",597,586,11,164,164,0,71,71,0,2009,NA,NA,NA,NA,NA,NA,NA,NA
"1137","VA","503","Virginia Beach CoC",433,394,39,218,218,0,69,69,0,2009,NA,NA,NA,NA,NA,NA,NA,NA
"1138","VA","504","Charlottesville CoC",199,185,14,38,38,0,12,12,0,2009,NA,NA,NA,NA,NA,NA,NA,NA
"1139","VA","505","Newport News, Hampton/Virginia Peninsula CoC",569,514,55,147,137,10,60,56,4,2009,NA,NA,NA,NA,NA,NA,NA,NA
"1140","VA","507","Portsmouth CoC",303,193,110,109,85,24,36,27,9,2009,NA,NA,NA,NA,NA,NA,NA,NA
"1141","VA","508","Lynchburg CoC",255,211,44,122,122,0,44,44,0,2009,NA,NA,NA,NA,NA,NA,NA,NA
"1142","VA","513","Harrisburg, Winchester/Western Virginia CoC",229,168,61,141,95,46,51,35,16,2009,NA,NA,NA,NA,NA,NA,NA,NA
"1143","VA","514","Fredericksburg/Spotsylvania, Stafford Counties CoC",202,95,107,62,55,7,20,17,3,2009,NA,NA,NA,NA,NA,NA,NA,NA
"1144","VA","521","Virginia Balance of State CoC",881,599,282,455,343,112,154,113,41,2009,NA,NA,NA,NA,NA,NA,NA,NA
"1145","VA","600","Arlington County CoC",511,304,207,189,189,0,56,56,0,2009,NA,NA,NA,NA,NA,NA,NA,NA
"1146","VA","601","Fairfax County CoC",1730,1601,129,1067,1067,0,315,315,0,2009,NA,NA,NA,NA,NA,NA,NA,NA
"1147","VA","602","Loudoun County CoC",143,108,35,94,83,11,28,25,3,2009,NA,NA,NA,NA,NA,NA,NA,NA
"1148","VA","603","Alexandria CoC",335,303,32,135,135,0,43,43,0,2009,NA,NA,NA,NA,NA,NA,NA,NA
"1149","VA","604","Prince William County CoC",630,392,238,406,274,132,135,89,46,2009,NA,NA,NA,NA,NA,NA,NA,NA
"1150","VT","500","Vermont Balance of State CoC",649,524,125,255,228,27,84,73,11,2009,NA,NA,NA,NA,NA,NA,NA,NA
"1151","VT","501","Burlington/Chittenden County CoC",565,533,32,266,258,8,109,105,4,2009,NA,NA,NA,NA,NA,NA,NA,NA
"1152","WA","500","Seattle/King County CoC",8952,6089,2863,3349,3313,36,1028,1015,13,2009,NA,NA,NA,NA,NA,NA,NA,NA
"1153","WA","501","Washington Balance of State CoC",7003,5050,1953,3641,2979,662,1232,990,242,2009,NA,NA,NA,NA,NA,NA,NA,NA
"1154","WA","502","Spokane City & County CoC",1229,1072,157,556,514,42,174,153,21,2009,NA,NA,NA,NA,NA,NA,NA,NA
"1155","WA","503","Tacoma, Lakewood/Pierce County CoC",2083,1853,230,1335,1307,28,398,388,10,2009,NA,NA,NA,NA,NA,NA,NA,NA
"1156","WA","504","Everett/Snohomish County CoC",2356,1246,1110,1193,953,240,399,321,78,2009,NA,NA,NA,NA,NA,NA,NA,NA
"1157","WA","508","Vancouver/Clark County CoC",1159,927,232,622,532,90,234,204,30,2009,NA,NA,NA,NA,NA,NA,NA,NA
"1158","WI","500","Wisconsin Balance of State CoC",3992,3207,785,2404,1872,532,811,621,190,2009,NA,NA,NA,NA,NA,NA,NA,NA
"1159","WI","501","Milwaukee City & County CoC",1537,1317,220,563,491,72,173,149,24,2009,NA,NA,NA,NA,NA,NA,NA,NA
"1160","WI","502","Racine City & County CoC",354,353,1,104,104,0,31,31,0,2009,NA,NA,NA,NA,NA,NA,NA,NA
"1161","WI","503","Madison/Dane County CoC",642,588,54,293,265,28,93,82,11,2009,NA,NA,NA,NA,NA,NA,NA,NA
"1162","WV","500","Wheeling, Weirton Area CoC",87,87,0,16,16,0,6,6,0,2009,NA,NA,NA,NA,NA,NA,NA,NA
"1163","WV","501","Huntington/Cabell, Wayne Counties CoC",195,190,5,65,65,0,20,20,0,2009,NA,NA,NA,NA,NA,NA,NA,NA
"1164","WV","503","Charleston/Kanawha, Putnam, Boone, Clay Counties CoC",382,331,51,98,98,0,28,28,0,2009,NA,NA,NA,NA,NA,NA,NA,NA
"1165","WV","508","West Virginia Balance of State CoC",1003,670,333,387,251,136,123,84,39,2009,NA,NA,NA,NA,NA,NA,NA,NA
"1166","WY","500","Wyoming Statewide CoC",515,451,64,175,169,6,72,70,2,2009,NA,NA,NA,NA,NA,NA,NA,NA
"1167",NA,NA,"Total",630227,403308,226919,238096,187313,50783,78514,60843,17671,2009,NA,NA,NA,NA,NA,NA,NA,NA
"1168","AK","500","Anchorage CoC",1231,1113,118,491,480,11,151,147,4,2010,NA,NA,NA,NA,NA,NA,NA,NA
"1169","AK","501","Alaska Balance of State CoC",632,558,74,254,238,16,93,89,4,2010,NA,NA,NA,NA,NA,NA,NA,NA
"1170","AL","500","Birmingham/Jefferson, St. Clair, Shelby Counties CoC",2273,1069,1204,628,313,315,235,117,118,2010,NA,NA,NA,NA,NA,NA,NA,NA
"1171","AL","501","Mobile City & County/Baldwin County CoC",883,482,401,343,273,70,131,112,19,2010,NA,NA,NA,NA,NA,NA,NA,NA
"1172","AL","502","Florence/Northwest Alabama CoC",170,162,8,39,35,4,8,7,1,2010,NA,NA,NA,NA,NA,NA,NA,NA
"1173","AL","503","Huntsville/North Alabama CoC",819,645,174,141,127,14,48,45,3,2010,NA,NA,NA,NA,NA,NA,NA,NA
"1174","AL","504","Montgomery City & County CoC",444,294,150,68,56,12,23,18,5,2010,NA,NA,NA,NA,NA,NA,NA,NA
"1175","AL","505","Gadsden/Northeast Alabama CoC",370,294,76,149,119,30,60,48,12,2010,NA,NA,NA,NA,NA,NA,NA,NA
"1176","AL","506","Tuscaloosa City & County CoC",278,263,15,7,7,0,3,3,0,2010,NA,NA,NA,NA,NA,NA,NA,NA
"1177","AL","507","Alabama Balance of State CoC",809,682,127,118,104,14,43,39,4,2010,NA,NA,NA,NA,NA,NA,NA,NA
"1178","AR","500","Little Rock/Central Arkansas CoC",1425,973,452,246,238,8,66,64,2,2010,NA,NA,NA,NA,NA,NA,NA,NA
"1179","AR","501","Fayetteville/Northwest Arkansas CoC",251,221,30,104,103,1,45,44,1,2010,NA,NA,NA,NA,NA,NA,NA,NA
"1180","AR","504","Delta Hills CoC",969,459,510,238,49,189,95,20,75,2010,NA,NA,NA,NA,NA,NA,NA,NA
"1181","AR","505","Southeast Arkansas CoC",51,51,0,20,20,0,7,7,0,2010,NA,NA,NA,NA,NA,NA,NA,NA
"1182","AR","512","Boone, Baxter, Marion, Newton Counties CoC",66,24,42,34,6,28,9,2,7,2010,NA,NA,NA,NA,NA,NA,NA,NA
"1183","AZ","500","Arizona Balance of State CoC",3069,1005,2064,984,548,436,288,177,111,2010,NA,NA,NA,NA,NA,NA,NA,NA
"1184","AZ","501","Tucson/Pima County CoC",3643,1939,1704,934,875,59,295,273,22,2010,NA,NA,NA,NA,NA,NA,NA,NA
"1185","AZ","502","Phoenix, Mesa/Maricopa County CoC",6999,4270,2729,2567,2425,142,789,742,47,2010,NA,NA,NA,NA,NA,NA,NA,NA
"1186","CA","500","San Jose/Santa Clara City & County CoC",7086,2103,4983,1008,942,66,285,264,21,2010,NA,NA,NA,NA,NA,NA,NA,NA
"1187","CA","501","San Francisco CoC",5823,2881,2942,514,489,25,178,168,10,2010,NA,NA,NA,NA,NA,NA,NA,NA
"1188","CA","502","Oakland, Berkeley/Alameda County CoC",4341,2378,1963,1570,1148,422,484,412,72,2010,NA,NA,NA,NA,NA,NA,NA,NA
"1189","CA","503","Sacramento City & County CoC",2734,1540,1194,571,555,16,197,191,6,2010,NA,NA,NA,NA,NA,NA,NA,NA
"1190","CA","504","Santa Rosa, Petaluma/Sonoma County CoC",3345,1123,2222,575,569,6,205,203,2,2010,NA,NA,NA,NA,NA,NA,NA,NA
"1191","CA","505","Richmond/Contra Costa County CoC",2759,887,1872,394,384,10,121,116,5,2010,NA,NA,NA,NA,NA,NA,NA,NA
"1192","CA","506","Salinas/Monterey, San Benito Counties CoC",2407,779,1628,498,376,122,117,89,28,2010,NA,NA,NA,NA,NA,NA,NA,NA
"1193","CA","507","Marin County CoC",1026,597,429,259,230,29,85,75,10,2010,NA,NA,NA,NA,NA,NA,NA,NA
"1194","CA","508","Watsonville/Santa Cruz City & County CoC",2265,729,1536,450,406,44,145,131,14,2010,NA,NA,NA,NA,NA,NA,NA,NA
"1195","CA","509","Mendocino County CoC",1202,235,967,131,109,22,44,37,7,2010,NA,NA,NA,NA,NA,NA,NA,NA
"1196","CA","510","Turlock, Modesto/Stanislaus County CoC",1800,801,999,682,317,365,281,116,165,2010,NA,NA,NA,NA,NA,NA,NA,NA
"1197","CA","511","Stockton/San Joaquin County CoC",3005,2840,165,883,883,0,281,281,0,2010,NA,NA,NA,NA,NA,NA,NA,NA
"1198","CA","512","Daly/San Mateo County CoC",1424,621,803,411,336,75,120,100,20,2010,NA,NA,NA,NA,NA,NA,NA,NA
"1199","CA","513","Visalia/Kings, Tulare Counties CoC",966,406,560,360,160,200,108,49,59,2010,NA,NA,NA,NA,NA,NA,NA,NA
"1200","CA","514","Fresno City & County/Madera County CoC",4288,1831,2457,994,802,192,313,236,77,2010,NA,NA,NA,NA,NA,NA,NA,NA
"1201","CA","515","Roseville, Rocklin/Placer, Nevada Counties CoC",1054,572,482,354,265,89,118,91,27,2010,NA,NA,NA,NA,NA,NA,NA,NA
"1202","CA","516","Redding/Shasta, Siskiyou, Lassen, Plumas, Del Norte, Modoc, Sierra Counties CoC",336,215,121,93,63,30,32,22,10,2010,NA,NA,NA,NA,NA,NA,NA,NA
"1203","CA","517","Napa City & County CoC",314,186,128,53,53,0,16,16,0,2010,NA,NA,NA,NA,NA,NA,NA,NA
"1204","CA","518","Vallejo/Solano County CoC",829,403,426,361,206,155,147,87,60,2010,NA,NA,NA,NA,NA,NA,NA,NA
"1205","CA","519","Chico, Paradise/Butte County CoC",742,347,395,127,99,28,47,38,9,2010,NA,NA,NA,NA,NA,NA,NA,NA
"1206","CA","520","Merced City & County CoC",372,148,224,28,28,0,10,10,0,2010,NA,NA,NA,NA,NA,NA,NA,NA
"1207","CA","521","Davis, Woodland/Yolo County CoC",491,202,289,126,110,16,41,34,7,2010,NA,NA,NA,NA,NA,NA,NA,NA
"1208","CA","522","Humboldt County CoC",1355,355,1000,466,145,321,138,52,86,2010,NA,NA,NA,NA,NA,NA,NA,NA
"1209","CA","523","Colusa, Glenn, Trinity Counties CoC",197,74,123,52,37,15,18,13,5,2010,NA,NA,NA,NA,NA,NA,NA,NA
"1210","CA","524","Yuba City & County/Sutter County CoC",512,387,125,236,216,20,72,65,7,2010,NA,NA,NA,NA,NA,NA,NA,NA
"1211","CA","525","El Dorado County CoC",146,63,83,48,40,8,15,12,3,2010,NA,NA,NA,NA,NA,NA,NA,NA
"1212","CA","526","Amador, Calaveras, Mariposa, Tuolumne Counties CoC",289,67,222,119,42,77,36,14,22,2010,NA,NA,NA,NA,NA,NA,NA,NA
"1213","CA","528","Del Norte County CoC",18,18,0,14,14,0,5,5,0,2010,NA,NA,NA,NA,NA,NA,NA,NA
"1214","CA","600","Los Angeles City & County CoC",33243,14050,19193,4885,3874,1011,1840,1365,475,2010,NA,NA,NA,NA,NA,NA,NA,NA
"1215","CA","601","San Diego City and County CoC",8383,3918,4465,1832,1292,540,688,451,237,2010,NA,NA,NA,NA,NA,NA,NA,NA
"1216","CA","602","Santa Ana, Anaheim/Orange County CoC",8333,2609,5724,1377,1296,81,481,454,27,2010,NA,NA,NA,NA,NA,NA,NA,NA
"1217","CA","603","Santa Maria/Santa Barbara County CoC",4121,1148,2973,788,402,386,262,135,127,2010,NA,NA,NA,NA,NA,NA,NA,NA
"1218","CA","604","Bakersfield/Kern County CoC",1499,667,832,248,203,45,78,60,18,2010,NA,NA,NA,NA,NA,NA,NA,NA
"1219","CA","606","Long Beach CoC",3909,2154,1755,709,494,215,224,156,68,2010,NA,NA,NA,NA,NA,NA,NA,NA
"1220","CA","607","Pasadena CoC",1137,491,646,262,165,97,91,56,35,2010,NA,NA,NA,NA,NA,NA,NA,NA
"1221","CA","608","Riverside City & County CoC",3126,1083,2043,1508,810,698,393,270,123,2010,NA,NA,NA,NA,NA,NA,NA,NA
"1222","CA","609","San Bernardino City & County CoC",2026,768,1258,629,461,168,221,176,45,2010,NA,NA,NA,NA,NA,NA,NA,NA
"1223","CA","611","Oxnard, San Buenaventura/Ventura County CoC",1815,524,1291,396,172,224,124,54,70,2010,NA,NA,NA,NA,NA,NA,NA,NA
"1224","CA","612","Glendale CoC",428,300,128,142,134,8,43,39,4,2010,NA,NA,NA,NA,NA,NA,NA,NA
"1225","CA","613","Imperial County CoC",505,157,348,105,105,0,33,33,0,2010,NA,NA,NA,NA,NA,NA,NA,NA
"1226","CA","614","San Luis Obispo County CoC",3829,242,3587,2282,165,2117,673,38,635,2010,NA,NA,NA,NA,NA,NA,NA,NA
"1227","CO","500","Colorado Balance of State CoC",5267,1087,4180,3943,808,3135,986,202,784,2010,NA,NA,NA,NA,NA,NA,NA,NA
"1228","CO","503","Metropolitan Denver CoC",8752,7053,1699,3671,3400,271,1156,1071,85,2010,NA,NA,NA,NA,NA,NA,NA,NA
"1229","CO","504","Colorado Springs/El Paso County CoC",1463,891,572,294,247,47,92,80,12,2010,NA,NA,NA,NA,NA,NA,NA,NA
"1230","CT","503","Bridgeport, Stamford, Norwalk/Fairfield County CoC",944,839,105,291,282,9,94,90,4,2010,NA,NA,NA,NA,NA,NA,NA,NA
"1231","CT","505","Connecticut Balance of State CoC",3372,2978,394,1032,1024,8,353,350,3,2010,NA,NA,NA,NA,NA,NA,NA,NA
"1232","DE","500","Delaware Statewide CoC",982,930,52,301,301,0,111,111,0,2010,NA,NA,NA,NA,NA,NA,NA,NA
"1233","FL","500","Sarasota, Bradenton/Manatee, Sarasota Counties CoC",1999,348,1651,798,155,643,231,55,176,2010,NA,NA,NA,NA,NA,NA,NA,NA
"1234","FL","501","Tampa/Hillsborough County CoC",7473,726,6747,3366,228,3138,1201,80,1121,2010,NA,NA,NA,NA,NA,NA,NA,NA
"1235","FL","502","St. Petersburg, Clearwater, Largo/Pinellas County CoC",3948,1791,2157,485,439,46,188,169,19,2010,NA,NA,NA,NA,NA,NA,NA,NA
"1236","FL","503","Lakeland, Winterhaven/Polk County CoC",820,443,377,126,88,38,37,26,11,2010,NA,NA,NA,NA,NA,NA,NA,NA
"1237","FL","504","Daytona Beach, Daytona/Volusia, Flagler Counties CoC",2155,703,1452,478,478,0,151,151,0,2010,NA,NA,NA,NA,NA,NA,NA,NA
"1238","FL","505","Fort Walton Beach/Okaloosa, Walton Counties CoC",2262,471,1791,1014,96,918,334,42,292,2010,NA,NA,NA,NA,NA,NA,NA,NA
"1239","FL","506","Tallahassee/Leon County CoC",640,536,104,165,138,27,48,40,8,2010,NA,NA,NA,NA,NA,NA,NA,NA
"1240","FL","507","Orlando/Orange, Osceola, Seminole Counties CoC",4041,2065,1976,1345,966,379,447,321,126,2010,NA,NA,NA,NA,NA,NA,NA,NA
"1241","FL","508","Gainesville/Alachua, Putnam Counties CoC",1019,297,722,245,103,142,111,40,71,2010,NA,NA,NA,NA,NA,NA,NA,NA
"1242","FL","509","Fort Pierce/St. Lucie, Indian River, Martin Counties CoC",2160,186,1974,1059,156,903,384,47,337,2010,NA,NA,NA,NA,NA,NA,NA,NA
"1243","FL","510","Jacksonville-Duval, Clay Counties CoC",3241,2069,1172,896,896,0,237,237,0,2010,NA,NA,NA,NA,NA,NA,NA,NA
"1244","FL","511","Pensacola/Escambia, Santa Rosa Counties CoC",1160,542,618,405,214,191,175,68,107,2010,NA,NA,NA,NA,NA,NA,NA,NA
"1245","FL","512","St. Johns County CoC",1252,201,1051,160,92,68,50,36,14,2010,NA,NA,NA,NA,NA,NA,NA,NA
"1246","FL","513","Palm Bay, Melbourne/Brevard County CoC",1221,1002,219,340,331,9,109,106,3,2010,NA,NA,NA,NA,NA,NA,NA,NA
"1247","FL","514","Ocala/Marion County CoC",576,382,194,303,207,96,125,101,24,2010,NA,NA,NA,NA,NA,NA,NA,NA
"1248","FL","515","Panama City/Bay, Jackson Counties CoC",326,224,102,119,89,30,40,32,8,2010,NA,NA,NA,NA,NA,NA,NA,NA
"1249","FL","517","Hendry, Hardee, Highlands Counties CoC",4220,101,4119,3408,38,3370,1619,14,1605,2010,NA,NA,NA,NA,NA,NA,NA,NA
"1250","FL","518","Columbia, Hamilton, Lafayette, Suwannee Counties CoC",1114,165,949,390,80,310,159,35,124,2010,NA,NA,NA,NA,NA,NA,NA,NA
"1251","FL","519","Pasco County CoC",4527,1674,2853,3215,1125,2090,1286,450,836,2010,NA,NA,NA,NA,NA,NA,NA,NA
"1252","FL","520","Citrus, Hernando, Lake, Sumter Counties CoC",1385,295,1090,422,76,346,126,28,98,2010,NA,NA,NA,NA,NA,NA,NA,NA
"1253","FL","600","Miami-Dade County CoC",3879,3120,759,1317,1317,0,397,397,0,2010,NA,NA,NA,NA,NA,NA,NA,NA
"1254","FL","601","Ft Lauderdale/Broward County CoC",3225,2425,800,650,586,64,206,189,17,2010,NA,NA,NA,NA,NA,NA,NA,NA
"1255","FL","602","Punta Gorda/Charlotte County CoC",376,202,174,91,44,47,39,16,23,2010,NA,NA,NA,NA,NA,NA,NA,NA
"1256","FL","603","Ft Myers, Cape Coral/Lee County CoC",944,461,483,224,114,110,55,33,22,2010,NA,NA,NA,NA,NA,NA,NA,NA
"1257","FL","604","Monroe County CoC",1040,324,716,202,98,104,81,29,52,2010,NA,NA,NA,NA,NA,NA,NA,NA
"1258","FL","605","West Palm Beach/Palm Beach County CoC",2147,740,1407,465,307,158,138,89,49,2010,NA,NA,NA,NA,NA,NA,NA,NA
"1259","FL","606","Naples/Collier County CoC",401,324,77,125,125,0,43,43,0,2010,NA,NA,NA,NA,NA,NA,NA,NA
"1260","GA","500","Atlanta CoC",7019,4855,2164,1238,1142,96,492,459,33,2010,NA,NA,NA,NA,NA,NA,NA,NA
"1261","GA","501","Georgia Balance of State CoC",9750,1943,7807,3435,1304,2131,1058,412,646,2010,NA,NA,NA,NA,NA,NA,NA,NA
"1262","GA","503","Athens-Clarke County CoC",496,269,227,143,127,16,44,39,5,2010,NA,NA,NA,NA,NA,NA,NA,NA
"1263","GA","504","Augusta-Richmond County CoC",556,512,44,151,128,23,51,34,17,2010,NA,NA,NA,NA,NA,NA,NA,NA
"1264","GA","505","Columbus-Muscogee/Russell County CoC",468,264,204,117,61,56,34,17,17,2010,NA,NA,NA,NA,NA,NA,NA,NA
"1265","GA","506","Marietta/Cobb County CoC",470,344,126,204,201,3,70,69,1,2010,NA,NA,NA,NA,NA,NA,NA,NA
"1266","GA","507","Savannah/Chatham County CoC",1077,559,518,171,171,0,63,63,0,2010,NA,NA,NA,NA,NA,NA,NA,NA
"1267","HI","500","Hawaii Balance of State CoC",1663,738,925,728,550,178,195,148,47,2010,NA,NA,NA,NA,NA,NA,NA,NA
"1268","HI","501","Honolulu City and County CoC",4171,2797,1374,2217,2041,176,569,527,42,2010,NA,NA,NA,NA,NA,NA,NA,NA
"1269","IA","500","Sioux City/Dakota, Woodbury Counties CoC",308,294,14,179,179,0,57,57,0,2010,NA,NA,NA,NA,NA,NA,NA,NA
"1270","IA","501","Iowa Balance of State CoC",1686,1653,33,973,966,7,318,315,3,2010,NA,NA,NA,NA,NA,NA,NA,NA
"1271","IA","502","Des Moines/Polk County CoC",1020,956,64,334,332,2,106,105,1,2010,NA,NA,NA,NA,NA,NA,NA,NA
"1272","ID","500","Boise/Ada County CoC",872,747,125,227,215,12,73,69,4,2010,NA,NA,NA,NA,NA,NA,NA,NA
"1273","ID","501","Idaho Balance of State CoC",1474,817,657,674,518,156,214,173,41,2010,NA,NA,NA,NA,NA,NA,NA,NA
"1274","IL","500","McHenry County CoC",212,211,1,88,88,0,30,30,0,2010,NA,NA,NA,NA,NA,NA,NA,NA
"1275","IL","501","Rockford/Winnebago, Boone Counties CoC",621,526,95,347,328,19,87,81,6,2010,NA,NA,NA,NA,NA,NA,NA,NA
"1276","IL","502","Waukegan, North Chicago/Lake County CoC",474,454,20,237,237,0,96,96,0,2010,NA,NA,NA,NA,NA,NA,NA,NA
"1277","IL","503","Champaign, Urbana, Rantoul/Champaign County CoC",534,530,4,325,325,0,124,124,0,2010,NA,NA,NA,NA,NA,NA,NA,NA
"1278","IL","504","Madison County CoC",202,161,41,140,130,10,42,39,3,2010,NA,NA,NA,NA,NA,NA,NA,NA
"1279","IL","506","Joliet, Bolingbrook/Will County CoC",389,358,31,202,197,5,66,64,2,2010,NA,NA,NA,NA,NA,NA,NA,NA
"1280","IL","507","Peoria, Pekin/Fulton, Tazewell, Peoria, Woodford Counties CoC",376,346,30,171,157,14,70,64,6,2010,NA,NA,NA,NA,NA,NA,NA,NA
"1281","IL","508","East St. Louis, Belleville/St. Clair County CoC",514,220,294,217,138,79,96,62,34,2010,NA,NA,NA,NA,NA,NA,NA,NA
"1282","IL","509","Dekalb City & County CoC",118,86,32,66,58,8,23,20,3,2010,NA,NA,NA,NA,NA,NA,NA,NA
"1283","IL","510","Chicago CoC",6240,5356,884,2898,2808,90,883,861,22,2010,NA,NA,NA,NA,NA,NA,NA,NA
"1284","IL","511","Cook County CoC",1390,1139,251,600,585,15,196,192,4,2010,NA,NA,NA,NA,NA,NA,NA,NA
"1285","IL","512","Bloomington/Central Illinois CoC",639,419,220,274,173,101,92,54,38,2010,NA,NA,NA,NA,NA,NA,NA,NA
"1286","IL","513","Springfield/Sangamon County CoC",287,284,3,111,111,0,45,45,0,2010,NA,NA,NA,NA,NA,NA,NA,NA
"1287","IL","514","DuPage County CoC",712,604,108,351,342,9,120,117,3,2010,NA,NA,NA,NA,NA,NA,NA,NA
"1288","IL","515","South Central Illinois CoC",190,172,18,144,135,9,38,35,3,2010,NA,NA,NA,NA,NA,NA,NA,NA
"1289","IL","516","Decatur/Macon County CoC",197,145,52,79,63,16,25,19,6,2010,NA,NA,NA,NA,NA,NA,NA,NA
"1290","IL","517","Aurora, Elgin/Kane County CoC",445,392,53,112,112,0,32,32,0,2010,NA,NA,NA,NA,NA,NA,NA,NA
"1291","IL","518","Rock Island, Moline/Northwestern Illinois CoC",392,385,7,215,215,0,72,72,0,2010,NA,NA,NA,NA,NA,NA,NA,NA
"1292","IL","519","West Central Illinois CoC",172,172,0,111,111,0,51,51,0,2010,NA,NA,NA,NA,NA,NA,NA,NA
"1293","IL","520","Southern Illinois CoC",291,248,43,139,128,11,41,38,3,2010,NA,NA,NA,NA,NA,NA,NA,NA
"1294","IN","502","Indiana Balance of State CoC",4958,3872,1086,2300,1935,365,731,624,107,2010,NA,NA,NA,NA,NA,NA,NA,NA
"1295","IN","503","Indianapolis CoC",1494,1361,133,564,562,2,182,181,1,2010,NA,NA,NA,NA,NA,NA,NA,NA
"1296","KS","502","Wichita/Sedgwick County CoC",384,352,32,74,74,0,25,25,0,2010,NA,NA,NA,NA,NA,NA,NA,NA
"1297","KS","503","Topeka/Shawnee County CoC",356,337,19,128,128,0,32,32,0,2010,NA,NA,NA,NA,NA,NA,NA,NA
"1298","KS","505","Overland Park, Shawnee/Johnson County CoC",210,166,44,152,121,31,48,38,10,2010,NA,NA,NA,NA,NA,NA,NA,NA
"1299","KS","507","Kansas Balance of State CoC",859,800,59,266,253,13,85,81,4,2010,NA,NA,NA,NA,NA,NA,NA,NA
"1300","KY","500","Kentucky Balance of State CoC",3446,2704,742,1619,1469,150,492,447,45,2010,NA,NA,NA,NA,NA,NA,NA,NA
"1301","KY","501","Louisville-Jefferson County CoC",1626,1460,166,385,385,0,137,137,0,2010,NA,NA,NA,NA,NA,NA,NA,NA
"1302","KY","502","Lexington-Fayette County CoC",1551,1435,116,494,484,10,176,172,4,2010,NA,NA,NA,NA,NA,NA,NA,NA
"1303","LA","500","Lafayette/Acadiana CoC",731,538,193,348,271,77,114,92,22,2010,NA,NA,NA,NA,NA,NA,NA,NA
"1304","LA","502","Shreveport, Bossier/Northwest Louisiana CoC",830,739,91,369,350,19,116,111,5,2010,NA,NA,NA,NA,NA,NA,NA,NA
"1305","LA","503","New Orleans/Jefferson Parish CoC",8725,1340,7385,768,477,291,252,160,92,2010,NA,NA,NA,NA,NA,NA,NA,NA
"1306","LA","505","Monroe/Northeast Louisiana CoC",228,187,41,135,118,17,38,33,5,2010,NA,NA,NA,NA,NA,NA,NA,NA
"1307","LA","506","Slidell/Southeast Louisiana CoC",357,195,162,190,113,77,70,42,28,2010,NA,NA,NA,NA,NA,NA,NA,NA
"1308","LA","507","Alexandria/Central Louisiana CoC",151,104,47,48,30,18,15,9,6,2010,NA,NA,NA,NA,NA,NA,NA,NA
"1309","LA","509","Louisiana Balance of State CoC",1460,993,467,523,347,176,158,107,51,2010,NA,NA,NA,NA,NA,NA,NA,NA
"1310","MA","500","Boston CoC",5139,4884,255,2768,2768,0,947,947,0,2010,NA,NA,NA,NA,NA,NA,NA,NA
"1311","MA","501","Holyoke/Franklin, Hampden, Hampshire Counties CoC",1881,1813,68,1338,1338,0,421,421,0,2010,NA,NA,NA,NA,NA,NA,NA,NA
"1312","MA","502","Lynn CoC",464,439,25,310,310,0,102,102,0,2010,NA,NA,NA,NA,NA,NA,NA,NA
"1313","MA","503","Cape Cod Islands CoC",504,313,191,229,169,60,87,66,21,2010,NA,NA,NA,NA,NA,NA,NA,NA
"1314","MA","504","Springfield/Hampden County CoC",886,876,10,578,578,0,188,188,0,2010,NA,NA,NA,NA,NA,NA,NA,NA
"1315","MA","505","New Bedford CoC",374,337,37,98,98,0,35,35,0,2010,NA,NA,NA,NA,NA,NA,NA,NA
"1316","MA","506","Worcester City & County CoC",1409,1354,55,927,921,6,319,317,2,2010,NA,NA,NA,NA,NA,NA,NA,NA
"1317","MA","507","Pittsfield/Berkshire, Franklin, Hampshire Counties CoC",280,193,87,116,51,65,46,22,24,2010,NA,NA,NA,NA,NA,NA,NA,NA
"1318","MA","508","Lowell CoC",526,485,41,347,347,0,111,111,0,2010,NA,NA,NA,NA,NA,NA,NA,NA
"1319","MA","509","Cambridge CoC",559,489,70,219,219,0,83,83,0,2010,NA,NA,NA,NA,NA,NA,NA,NA
"1320","MA","510","Gloucester, Haverhill, Salem/Essex County CoC",997,911,86,657,657,0,231,231,0,2010,NA,NA,NA,NA,NA,NA,NA,NA
"1321","MA","511","Quincy, Brockton, Weymouth, Plymouth City and County CoC",1186,1155,31,820,820,0,289,289,0,2010,NA,NA,NA,NA,NA,NA,NA,NA
"1322","MA","515","Fall River CoC",253,238,15,137,137,0,46,46,0,2010,NA,NA,NA,NA,NA,NA,NA,NA
"1323","MA","516","Massachusetts Balance of State CoC",1872,1831,41,1534,1534,0,554,554,0,2010,NA,NA,NA,NA,NA,NA,NA,NA
"1324","MA","517","Somerville CoC",142,138,4,61,61,0,24,24,0,2010,NA,NA,NA,NA,NA,NA,NA,NA
"1325","MA","519","Attleboro, Taunton/Bristol County CoC",174,139,35,104,104,0,43,43,0,2010,NA,NA,NA,NA,NA,NA,NA,NA
"1326","MD","500","Cumberland/Allegany County CoC",107,92,15,58,55,3,17,16,1,2010,NA,NA,NA,NA,NA,NA,NA,NA
"1327","MD","501","Baltimore CoC",3419,2191,1228,935,444,491,359,163,196,2010,NA,NA,NA,NA,NA,NA,NA,NA
"1328","MD","502","Harford County CoC",228,178,50,58,58,0,21,21,0,2010,NA,NA,NA,NA,NA,NA,NA,NA
"1329","MD","503","Annapolis/Anne Arundel County CoC",395,266,129,133,133,0,39,39,0,2010,NA,NA,NA,NA,NA,NA,NA,NA
"1330","MD","504","Howard County CoC",221,157,64,129,119,10,43,40,3,2010,NA,NA,NA,NA,NA,NA,NA,NA
"1331","MD","505","Baltimore County CoC",891,589,302,442,363,79,142,118,24,2010,NA,NA,NA,NA,NA,NA,NA,NA
"1332","MD","506","Carroll County CoC",211,183,28,79,69,10,27,23,4,2010,NA,NA,NA,NA,NA,NA,NA,NA
"1333","MD","507","Cecil County CoC",173,146,27,83,77,6,36,34,2,2010,NA,NA,NA,NA,NA,NA,NA,NA
"1334","MD","508","Charles, Calvert, St.Mary's Counties CoC",2560,536,2024,1920,312,1608,594,94,500,2010,NA,NA,NA,NA,NA,NA,NA,NA
"1335","MD","509","Frederick City & County CoC",303,252,51,111,111,0,39,39,0,2010,NA,NA,NA,NA,NA,NA,NA,NA
"1336","MD","510","Garrett County CoC",11,4,7,0,0,0,0,0,0,2010,NA,NA,NA,NA,NA,NA,NA,NA
"1337","MD","511","Mid-Shore Regional CoC",96,68,28,26,20,6,9,7,2,2010,NA,NA,NA,NA,NA,NA,NA,NA
"1338","MD","512","Hagerstown/Washington County CoC",137,110,27,77,57,20,28,21,7,2010,NA,NA,NA,NA,NA,NA,NA,NA
"1339","MD","513","Wicomico, Somerset, Worcester Counties CoC",240,197,43,65,65,0,24,24,0,2010,NA,NA,NA,NA,NA,NA,NA,NA
"1340","MD","600","Prince George's County CoC",789,663,126,358,358,0,101,101,0,2010,NA,NA,NA,NA,NA,NA,NA,NA
"1341","MD","601","Montgomery County CoC",1064,883,181,372,372,0,124,124,0,2010,NA,NA,NA,NA,NA,NA,NA,NA
"1342","ME","500","Maine Statewide CoC",2379,2351,28,1318,1318,0,447,447,0,2010,NA,NA,NA,NA,NA,NA,NA,NA
"1343","MI","500","Michigan Balance of State CoC",2953,2031,922,1802,1415,387,619,492,127,2010,NA,NA,NA,NA,NA,NA,NA,NA
"1344","MI","501","Detroit CoC",2812,2550,262,378,378,0,141,141,0,2010,NA,NA,NA,NA,NA,NA,NA,NA
"1345","MI","502","Dearborn, Dearborn Heights, Westland/Wayne County CoC",458,452,6,305,305,0,82,82,0,2010,NA,NA,NA,NA,NA,NA,NA,NA
"1346","MI","503","St. Clair Shores, Warren/Macomb County CoC",896,311,585,351,105,246,105,34,71,2010,NA,NA,NA,NA,NA,NA,NA,NA
"1347","MI","504","Pontiac, Royal Oak/Oakland County CoC",731,451,280,239,201,38,78,66,12,2010,NA,NA,NA,NA,NA,NA,NA,NA
"1348","MI","505","Flint/Genesee County CoC",277,199,78,94,92,2,29,28,1,2010,NA,NA,NA,NA,NA,NA,NA,NA
"1349","MI","506","Grand Rapids, Wyoming/Kent County CoC",585,575,10,357,357,0,118,118,0,2010,NA,NA,NA,NA,NA,NA,NA,NA
"1350","MI","507","Portage, Kalamazoo City & County CoC",679,637,42,384,384,0,117,117,0,2010,NA,NA,NA,NA,NA,NA,NA,NA
"1351","MI","508","Lansing, East Lansing/Ingham County CoC",535,392,143,146,140,6,45,44,1,2010,NA,NA,NA,NA,NA,NA,NA,NA
"1352","MI","509","Washtenaw County CoC",474,439,35,168,166,2,50,49,1,2010,NA,NA,NA,NA,NA,NA,NA,NA
"1353","MI","510","Saginaw City & County CoC",305,278,27,129,129,0,43,43,0,2010,NA,NA,NA,NA,NA,NA,NA,NA
"1354","MI","511","Lenawee County CoC",120,115,5,80,77,3,22,21,1,2010,NA,NA,NA,NA,NA,NA,NA,NA
"1355","MI","512","Grand Traverse, Antrim, Leelanau Counties CoC",296,285,11,169,169,0,60,60,0,2010,NA,NA,NA,NA,NA,NA,NA,NA
"1356","MI","513","Marquette, Alger Counties CoC",68,63,5,40,40,0,14,14,0,2010,NA,NA,NA,NA,NA,NA,NA,NA
"1357","MI","514","Battle Creek/Calhoun County CoC",186,133,53,50,45,5,13,12,1,2010,NA,NA,NA,NA,NA,NA,NA,NA
"1358","MI","515","Monroe City & County CoC",140,136,4,65,62,3,30,29,1,2010,NA,NA,NA,NA,NA,NA,NA,NA
"1359","MI","516","Norton Shores, Muskegon City & County CoC",646,325,321,338,193,145,135,76,59,2010,NA,NA,NA,NA,NA,NA,NA,NA
"1360","MI","517","Jackson City & County CoC",323,304,19,202,202,0,64,64,0,2010,NA,NA,NA,NA,NA,NA,NA,NA
"1361","MI","518","Livingston County CoC",121,108,13,75,75,0,23,23,0,2010,NA,NA,NA,NA,NA,NA,NA,NA
"1362","MI","519","Holland/Ottawa County CoC",306,304,2,202,202,0,59,59,0,2010,NA,NA,NA,NA,NA,NA,NA,NA
"1363","MI","523","Eaton County CoC",147,131,16,119,111,8,33,30,3,2010,NA,NA,NA,NA,NA,NA,NA,NA
"1364","MN","500","Minneapolis/Hennepin County CoC",3056,2808,248,1226,1176,50,411,389,22,2010,NA,NA,NA,NA,NA,NA,NA,NA
"1365","MN","501","Saint Paul/Ramsey County CoC",1424,1328,96,778,778,0,248,248,0,2010,NA,NA,NA,NA,NA,NA,NA,NA
"1366","MN","502","Rochester/Southeast Minnesota CoC",419,406,13,316,316,0,98,98,0,2010,NA,NA,NA,NA,NA,NA,NA,NA
"1367","MN","503","Dakota, Anoka, Washington, Scott, Carver Counties",924,749,175,728,613,115,250,207,43,2010,NA,NA,NA,NA,NA,NA,NA,NA
"1368","MN","504","Northeast Minnesota CoC",208,89,119,121,66,55,46,20,26,2010,NA,NA,NA,NA,NA,NA,NA,NA
"1369","MN","505","St. Cloud/Central Minnesota CoC",541,433,108,296,263,33,93,87,6,2010,NA,NA,NA,NA,NA,NA,NA,NA
"1370","MN","506","Northwest Minnesota CoC",422,254,168,303,175,128,101,60,41,2010,NA,NA,NA,NA,NA,NA,NA,NA
"1371","MN","508","Moorhead/West Central Minnesota CoC",278,196,82,162,109,53,55,38,17,2010,NA,NA,NA,NA,NA,NA,NA,NA
"1372","MN","509","Duluth/St.Louis County CoC",524,406,118,284,256,28,92,83,9,2010,NA,NA,NA,NA,NA,NA,NA,NA
"1373","MN","511","Southwest Minnesota CoC",73,61,12,50,44,6,15,14,1,2010,NA,NA,NA,NA,NA,NA,NA,NA
"1374","MO","500","St. Louis County CoC",659,408,251,451,316,135,137,96,41,2010,NA,NA,NA,NA,NA,NA,NA,NA
"1375","MO","501","St.Louis City CoC",1305,1168,137,571,535,36,179,167,12,2010,NA,NA,NA,NA,NA,NA,NA,NA
"1376","MO","503","St. Charles City & County, Lincoln, Warren Counties CoC",1089,688,401,702,454,248,233,152,81,2010,NA,NA,NA,NA,NA,NA,NA,NA
"1377","MO","600","Springfield/Greene, Christian, Webster Counties CoC",662,503,159,234,234,0,92,92,0,2010,NA,NA,NA,NA,NA,NA,NA,NA
"1378","MO","602","Joplin/Jasper, Newton Counties CoC",393,319,74,116,116,0,36,36,0,2010,NA,NA,NA,NA,NA,NA,NA,NA
"1379","MO","603","St. Joseph/Andrew, Buchanan, DeKalb Counties CoC",164,138,26,24,24,0,9,9,0,2010,NA,NA,NA,NA,NA,NA,NA,NA
"1380","MO","604a","Kansas City, Independence, Lee’s Summit/Jackson, Wyandotte Counties, MO & KS",2153,1946,207,863,863,0,275,275,0,2010,NA,NA,NA,NA,NA,NA,NA,NA
"1381","MO","606","Missouri Balance of State CoC",1912,1339,573,820,590,230,257,189,68,2010,NA,NA,NA,NA,NA,NA,NA,NA
"1382","MS","500","Jackson/Rankin, Madison Counties CoC",914,432,482,113,103,10,46,41,5,2010,NA,NA,NA,NA,NA,NA,NA,NA
"1383","MS","501","Mississippi Balance of State CoC",1242,660,582,661,383,278,199,106,93,2010,NA,NA,NA,NA,NA,NA,NA,NA
"1384","MS","503","Gulf Port/Gulf Coast Regional CoC",587,89,498,45,34,11,19,14,5,2010,NA,NA,NA,NA,NA,NA,NA,NA
"1385","MT","500","Montana Statewide CoC",1615,1168,447,725,606,119,238,201,37,2010,NA,NA,NA,NA,NA,NA,NA,NA
"1386","NC","500","Winston-Salem/Forsyth County CoC",543,502,41,154,154,0,51,51,0,2010,NA,NA,NA,NA,NA,NA,NA,NA
"1387","NC","501","Asheville/Buncombe County CoC",516,462,54,101,101,0,40,40,0,2010,NA,NA,NA,NA,NA,NA,NA,NA
"1388","NC","502","Durham City & County CoC",675,607,68,141,139,2,51,50,1,2010,NA,NA,NA,NA,NA,NA,NA,NA
"1389","NC","503","North Carolina Balance of State CoC",2851,2206,645,1027,939,88,353,312,41,2010,NA,NA,NA,NA,NA,NA,NA,NA
"1390","NC","504","Greensboro, High Point CoC",1070,934,136,332,327,5,112,110,2,2010,NA,NA,NA,NA,NA,NA,NA,NA
"1391","NC","505","Charlotte/Mecklenberg CoC",2841,2090,751,673,673,0,243,243,0,2010,NA,NA,NA,NA,NA,NA,NA,NA
"1392","NC","506","Wilmington/Brunswick, New Hanover, Pender Counties CoC",678,571,107,297,293,4,76,74,2,2010,NA,NA,NA,NA,NA,NA,NA,NA
"1393","NC","507","Raleigh/Wake County CoC",1180,1059,121,288,288,0,113,113,0,2010,NA,NA,NA,NA,NA,NA,NA,NA
"1394","NC","509","Gastonia/Cleveland, Gaston, Lincoln Counties CoC",324,206,118,60,60,0,24,24,0,2010,NA,NA,NA,NA,NA,NA,NA,NA
"1395","NC","511","Fayetteville/Cumberland County CoC",1033,294,739,495,216,279,145,57,88,2010,NA,NA,NA,NA,NA,NA,NA,NA
"1396","NC","513","Chapel Hill/Orange County CoC",135,118,17,24,24,0,9,9,0,2010,NA,NA,NA,NA,NA,NA,NA,NA
"1397","NC","516","Northwest North Carolina CoC",345,124,221,238,67,171,76,25,51,2010,NA,NA,NA,NA,NA,NA,NA,NA
"1398","ND","500","North Dakota Statewide CoC",799,768,31,260,255,5,82,80,2,2010,NA,NA,NA,NA,NA,NA,NA,NA
"1399","NE","500","Nebraska Balance of State CoC",1540,1196,344,741,626,115,250,214,36,2010,NA,NA,NA,NA,NA,NA,NA,NA
"1400","NE","501","Omaha, Council Bluffs CoC",1429,1335,94,346,346,0,109,109,0,2010,NA,NA,NA,NA,NA,NA,NA,NA
"1401","NE","502","Lincoln CoC",908,824,84,367,365,2,123,122,1,2010,NA,NA,NA,NA,NA,NA,NA,NA
"1402","NH","500","New Hampshire Balance of State CoC",813,710,103,336,323,13,111,106,5,2010,NA,NA,NA,NA,NA,NA,NA,NA
"1403","NH","501","Manchester CoC",415,320,95,137,133,4,56,54,2,2010,NA,NA,NA,NA,NA,NA,NA,NA
"1404","NH","502","Nashua/Hillsborough County CoC",346,307,39,158,141,17,69,63,6,2010,NA,NA,NA,NA,NA,NA,NA,NA
"1405","NJ","500","Atlantic City & County CoC",588,456,132,77,62,15,28,23,5,2010,NA,NA,NA,NA,NA,NA,NA,NA
"1406","NJ","501","Bergen County CoC",522,450,72,184,169,15,63,58,5,2010,NA,NA,NA,NA,NA,NA,NA,NA
"1407","NJ","502","Burlington County CoC",716,688,28,378,368,10,127,124,3,2010,NA,NA,NA,NA,NA,NA,NA,NA
"1408","NJ","503","Camden City & County/Gloucester, Cape May, Cumberland Counties CoC",1572,1221,351,768,682,86,272,239,33,2010,NA,NA,NA,NA,NA,NA,NA,NA
"1409","NJ","504","Newark/Essex County CoC",1716,1497,219,874,820,54,324,299,25,2010,NA,NA,NA,NA,NA,NA,NA,NA
"1410","NJ","506","Jersey City, Bayonne/Hudson County CoC",1779,1597,182,1142,1109,33,436,422,14,2010,NA,NA,NA,NA,NA,NA,NA,NA
"1411","NJ","507","New Brunswick/Middlesex County CoC",1535,1353,182,944,888,56,325,302,23,2010,NA,NA,NA,NA,NA,NA,NA,NA
"1412","NJ","508","Monmouth County CoC",604,576,28,382,371,11,141,136,5,2010,NA,NA,NA,NA,NA,NA,NA,NA
"1413","NJ","509","Morris County CoC",297,240,57,130,122,8,49,45,4,2010,NA,NA,NA,NA,NA,NA,NA,NA
"1414","NJ","510","Lakewood Township/Ocean County CoC",590,542,48,280,266,14,96,91,5,2010,NA,NA,NA,NA,NA,NA,NA,NA
"1415","NJ","511","Paterson/Passaic County CoC",698,533,165,350,305,45,125,106,19,2010,NA,NA,NA,NA,NA,NA,NA,NA
"1416","NJ","512","Salem County CoC",146,146,0,63,63,0,22,22,0,2010,NA,NA,NA,NA,NA,NA,NA,NA
"1417","NJ","513","Somerset County CoC",310,296,14,148,145,3,47,46,1,2010,NA,NA,NA,NA,NA,NA,NA,NA
"1418","NJ","514","Trenton/Mercer County CoC",901,774,127,424,390,34,150,140,10,2010,NA,NA,NA,NA,NA,NA,NA,NA
"1419","NJ","515","Elizabeth/Union County CoC",1212,1194,18,747,741,6,252,249,3,2010,NA,NA,NA,NA,NA,NA,NA,NA
"1420","NJ","516","Warren, Sussex, Hunterdon Counties CoC",551,520,31,326,311,15,115,109,6,2010,NA,NA,NA,NA,NA,NA,NA,NA
"1421","NM","500","Albuquerque CoC",2002,1071,931,548,454,94,180,141,39,2010,NA,NA,NA,NA,NA,NA,NA,NA
"1422","NM","501","New Mexico Balance of State CoC",1473,1037,436,584,552,32,124,111,13,2010,NA,NA,NA,NA,NA,NA,NA,NA
"1423","NV","500","Las Vegas/Clark County CoC",9949,7004,2945,1383,1370,13,342,338,4,2010,NA,NA,NA,NA,NA,NA,NA,NA
"1424","NV","501","Reno, Sparks/Washoe County CoC",934,695,239,144,144,0,47,47,0,2010,NA,NA,NA,NA,NA,NA,NA,NA
"1425","NV","502","Nevada Balance of State CoC",322,149,173,113,101,12,46,40,6,2010,NA,NA,NA,NA,NA,NA,NA,NA
"1426","NY","500","Rochester, Irondequoit, Greece/Monroe County CoC",709,705,4,334,334,0,103,103,0,2010,NA,NA,NA,NA,NA,NA,NA,NA
"1427","NY","501","Elmira/Steuben, Allegany, Livingston, Chemung, Schuyler Counties CoC",256,245,11,54,50,4,18,17,1,2010,NA,NA,NA,NA,NA,NA,NA,NA
"1428","NY","503","Albany City & County CoC",650,612,38,208,208,0,71,71,0,2010,NA,NA,NA,NA,NA,NA,NA,NA
"1429","NY","504","Cattaragus County CoC",118,64,54,83,32,51,30,12,18,2010,NA,NA,NA,NA,NA,NA,NA,NA
"1430","NY","505","Syracuse, Auburn/Onondaga, Oswego, Cayuga Counties CoC",840,809,31,163,151,12,61,55,6,2010,NA,NA,NA,NA,NA,NA,NA,NA
"1431","NY","506","Fulton, Montgomery, Schoharie Counties CoC",19,12,7,6,3,3,2,1,1,2010,NA,NA,NA,NA,NA,NA,NA,NA
"1432","NY","507","Schenectady City & County CoC",389,363,26,165,165,0,54,54,0,2010,NA,NA,NA,NA,NA,NA,NA,NA
"1433","NY","508","Buffalo, Niagara Falls/Erie, Niagara, Orleans, Genesee, Wyoming Counties CoC",1137,924,213,332,312,20,135,126,9,2010,NA,NA,NA,NA,NA,NA,NA,NA
"1434","NY","510","Ithaca/Tompkins County CoC",73,63,10,32,32,0,12,12,0,2010,NA,NA,NA,NA,NA,NA,NA,NA
"1435","NY","511","Binghamton, Union Town/Broome, Otsego, Chenango, Delaware, Cortland, Tioga Count",234,223,11,23,23,0,8,8,0,2010,NA,NA,NA,NA,NA,NA,NA,NA
"1436","NY","512","Troy/Rensselaer County CoC",314,269,45,231,231,0,114,114,0,2010,NA,NA,NA,NA,NA,NA,NA,NA
"1437","NY","513","Wayne, Ontario, Seneca, Yates Counties CoC",75,75,0,33,33,0,13,13,0,2010,NA,NA,NA,NA,NA,NA,NA,NA
"1438","NY","514","Jamestown, Dunkirk/Chautauqua County CoC",88,81,7,60,60,0,19,19,0,2010,NA,NA,NA,NA,NA,NA,NA,NA
"1439","NY","516","Clinton County CoC",84,76,8,21,19,2,9,8,1,2010,NA,NA,NA,NA,NA,NA,NA,NA
"1440","NY","518","Utica, Rome/Oneida, Madison Counties CoC",343,326,17,92,92,0,32,32,0,2010,NA,NA,NA,NA,NA,NA,NA,NA
"1441","NY","519","Columbia, Greene Counties CoC",305,301,4,144,144,0,40,40,0,2010,NA,NA,NA,NA,NA,NA,NA,NA
"1442","NY","520","Franklin, Essex Counties CoC",14,5,9,6,0,6,3,0,3,2010,NA,NA,NA,NA,NA,NA,NA,NA
"1443","NY","522","Jefferson, Lewis, St. Lawrence Counties CoC",121,120,1,18,18,0,9,9,0,2010,NA,NA,NA,NA,NA,NA,NA,NA
"1444","NY","523","Glens Falls, Saratoga Springs/Saratoga, Washington, Warren, Hamilton Counties Co",186,157,29,35,35,0,13,13,0,2010,NA,NA,NA,NA,NA,NA,NA,NA
"1445","NY","600","New York City CoC",53187,50076,3111,33195,33195,0,10332,10332,0,2010,NA,NA,NA,NA,NA,NA,NA,NA
"1446","NY","601","Poughkeepsie/Dutchess County CoC",476,436,40,196,196,0,90,90,0,2010,NA,NA,NA,NA,NA,NA,NA,NA
"1447","NY","602","Newburgh, Middletown/Orange County CoC",505,345,160,211,199,12,65,61,4,2010,NA,NA,NA,NA,NA,NA,NA,NA
"1448","NY","603","Nassau, Suffolk Counties CoC",3163,3087,76,2422,2422,0,751,751,0,2010,NA,NA,NA,NA,NA,NA,NA,NA
"1449","NY","604","Yonkers, Mount Vernon/Westchester County CoC",1339,1305,34,879,879,0,237,237,0,2010,NA,NA,NA,NA,NA,NA,NA,NA
"1450","NY","606","Rockland County CoC",141,89,52,48,48,0,17,17,0,2010,NA,NA,NA,NA,NA,NA,NA,NA
"1451","NY","607","Sullivan County CoC",400,394,6,136,136,0,33,33,0,2010,NA,NA,NA,NA,NA,NA,NA,NA
"1452","NY","608","Kingston/Ulster County CoC",440,305,135,186,158,28,61,55,6,2010,NA,NA,NA,NA,NA,NA,NA,NA
"1453","OH","500","Cincinnati/Hamilton County CoC",1006,931,75,297,297,0,97,97,0,2010,NA,NA,NA,NA,NA,NA,NA,NA
"1454","OH","501","Toledo/Lucas County CoC",986,856,130,314,307,7,111,109,2,2010,NA,NA,NA,NA,NA,NA,NA,NA
"1455","OH","502","Cleveland/Cuyahoga County CoC",2278,2140,138,495,492,3,171,170,1,2010,NA,NA,NA,NA,NA,NA,NA,NA
"1456","OH","503","Columbus/Franklin County CoC",1387,1253,134,433,424,9,132,129,3,2010,NA,NA,NA,NA,NA,NA,NA,NA
"1457","OH","504","Youngstown/Mahoning County CoC",183,179,4,86,86,0,25,25,0,2010,NA,NA,NA,NA,NA,NA,NA,NA
"1458","OH","505","Dayton, Kettering/Montgomery County CoC",884,858,26,259,259,0,96,96,0,2010,NA,NA,NA,NA,NA,NA,NA,NA
"1459","OH","506","Akron, Barberton/Summit County CoC",859,672,187,272,272,0,84,84,0,2010,NA,NA,NA,NA,NA,NA,NA,NA
"1460","OH","507","Ohio Balance of State CoC",4555,3462,1093,2511,2124,387,810,677,133,2010,NA,NA,NA,NA,NA,NA,NA,NA
"1461","OH","508","Canton, Massillon, Alliance/Stark County CoC",431,378,53,183,173,10,69,66,3,2010,NA,NA,NA,NA,NA,NA,NA,NA
"1462","OK","500","North Central Oklahoma CoC",323,179,144,116,67,49,39,23,16,2010,NA,NA,NA,NA,NA,NA,NA,NA
"1463","OK","501","Tulsa City & County CoC",905,882,23,187,187,0,60,60,0,2010,NA,NA,NA,NA,NA,NA,NA,NA
"1464","OK","502","Oklahoma City CoC",1128,889,239,238,224,14,79,72,7,2010,NA,NA,NA,NA,NA,NA,NA,NA
"1465","OK","503","Oklahoma Balance of State CoC",324,317,7,113,113,0,35,35,0,2010,NA,NA,NA,NA,NA,NA,NA,NA
"1466","OK","504","Norman/Cleveland County CoC",565,251,314,127,122,5,37,36,1,2010,NA,NA,NA,NA,NA,NA,NA,NA
"1467","OK","505","Northeast Oklahoma CoC",567,243,324,353,103,250,136,46,90,2010,NA,NA,NA,NA,NA,NA,NA,NA
"1468","OK","506","Southwest Oklahoma Regional CoC",272,252,20,116,113,3,30,29,1,2010,NA,NA,NA,NA,NA,NA,NA,NA
"1469","OK","507","Southeastern Oklahoma Regional CoC",1145,302,843,662,147,515,249,59,190,2010,NA,NA,NA,NA,NA,NA,NA,NA
"1470","OR","500","Eugene, Springfield/Lane County CoC",2580,991,1589,681,430,251,217,144,73,2010,NA,NA,NA,NA,NA,NA,NA,NA
"1471","OR","501","Portland, Gresham/Multnomah County CoC",4235,2644,1591,1292,1214,78,443,408,35,2010,NA,NA,NA,NA,NA,NA,NA,NA
"1472","OR","502","Medford, Ashland/Jackson County CoC",922,350,572,417,114,303,123,42,81,2010,NA,NA,NA,NA,NA,NA,NA,NA
"1473","OR","503","Central Oregon CoC",569,256,313,264,142,122,80,44,36,2010,NA,NA,NA,NA,NA,NA,NA,NA
"1474","OR","505","Oregon Balance of State CoC",8814,2606,6208,5235,1374,3861,1676,422,1254,2010,NA,NA,NA,NA,NA,NA,NA,NA
"1475","OR","506","Hillsboro, Beaverton/Washington County CoC",950,248,702,436,183,253,135,60,75,2010,NA,NA,NA,NA,NA,NA,NA,NA
"1476","OR","507","Clackamas County CoC",1422,136,1286,436,120,316,137,44,93,2010,NA,NA,NA,NA,NA,NA,NA,NA
"1477","PA","500","Philadelphia CoC",6084,5603,481,3007,3007,0,996,996,0,2010,NA,NA,NA,NA,NA,NA,NA,NA
"1478","PA","501","Harrisburg/Dauphin County CoC",394,306,88,156,150,6,57,54,3,2010,NA,NA,NA,NA,NA,NA,NA,NA
"1479","PA","502","Upper Darby, Chester, Haverford/Delaware County CoC",716,663,53,451,451,0,136,136,0,2010,NA,NA,NA,NA,NA,NA,NA,NA
"1480","PA","503","Wilkes-Barre, Hazleton/Luzerne County CoC",201,195,6,84,84,0,30,30,0,2010,NA,NA,NA,NA,NA,NA,NA,NA
"1481","PA","504","Lower Merion, Norristown, Abington/Montgomery County CoC",428,390,38,258,258,0,82,82,0,2010,NA,NA,NA,NA,NA,NA,NA,NA
"1482","PA","505","Chester County CoC",319,312,7,163,163,0,52,52,0,2010,NA,NA,NA,NA,NA,NA,NA,NA
"1483","PA","506","Reading/Berks County CoC",513,500,13,170,170,0,56,56,0,2010,NA,NA,NA,NA,NA,NA,NA,NA
"1484","PA","508","Scranton/Lackawanna County CoC",285,243,42,140,140,0,49,49,0,2010,NA,NA,NA,NA,NA,NA,NA,NA
"1485","PA","509","Eastern Pennsylvania CoC",1895,1752,143,1136,1119,17,363,357,6,2010,NA,NA,NA,NA,NA,NA,NA,NA
"1486","PA","510","Lancaster City & County CoC",602,579,23,300,300,0,101,101,0,2010,NA,NA,NA,NA,NA,NA,NA,NA
"1487","PA","511","Bristol, Bensalem/Bucks County CoC",474,438,36,305,305,0,103,103,0,2010,NA,NA,NA,NA,NA,NA,NA,NA
"1488","PA","600","Pittsburgh, McKeesport, Penn Hills/Allegheny County CoC",1265,1146,119,543,543,0,154,154,0,2010,NA,NA,NA,NA,NA,NA,NA,NA
"1489","PA","601","Western Pennsylvania CoC",910,890,20,467,467,0,153,153,0,2010,NA,NA,NA,NA,NA,NA,NA,NA
"1490","PA","603","Beaver County CoC",134,122,12,64,61,3,22,21,1,2010,NA,NA,NA,NA,NA,NA,NA,NA
"1491","PA","605","Erie City & County CoC",296,279,17,81,75,6,39,36,3,2010,NA,NA,NA,NA,NA,NA,NA,NA
"1492","RI","500","Rhode Island Statewide CoC",1282,1206,76,578,574,4,216,215,1,2010,NA,NA,NA,NA,NA,NA,NA,NA
"1493","SC","500","Charleston/Low Country CoC",416,347,69,79,79,0,27,27,0,2010,NA,NA,NA,NA,NA,NA,NA,NA
"1494","SC","501","Greenville, Anderson, Spartanburg/Upstate CoC",1164,1008,156,411,408,3,131,130,1,2010,NA,NA,NA,NA,NA,NA,NA,NA
"1495","SC","502","Columbia/Midlands CoC",1368,929,439,375,317,58,131,111,20,2010,NA,NA,NA,NA,NA,NA,NA,NA
"1496","SC","503","Myrtle Beach, Sumter City & County CoC",1525,752,773,414,287,127,185,135,50,2010,NA,NA,NA,NA,NA,NA,NA,NA
"1497","SD","500","South Dakota Statewide CoC",731,667,64,286,286,0,87,87,0,2010,NA,NA,NA,NA,NA,NA,NA,NA
"1498","TN","500","Chattanooga/Southeast Tennessee CoC",622,323,299,49,49,0,16,16,0,2010,NA,NA,NA,NA,NA,NA,NA,NA
"1499","TN","501","Memphis/Shelby County CoC",1657,1494,163,625,625,0,192,192,0,2010,NA,NA,NA,NA,NA,NA,NA,NA
"1500","TN","502","Knoxville/Knox County CoC",910,772,138,118,110,8,44,41,3,2010,NA,NA,NA,NA,NA,NA,NA,NA
"1501","TN","503","Central Tennessee CoC",177,159,18,41,41,0,16,16,0,2010,NA,NA,NA,NA,NA,NA,NA,NA
"1502","TN","504","Nashville-Davidson County CoC",2324,1985,339,226,226,0,73,73,0,2010,NA,NA,NA,NA,NA,NA,NA,NA
"1503","TN","506","Upper Cumberland CoC",635,179,456,252,75,177,80,24,56,2010,NA,NA,NA,NA,NA,NA,NA,NA
"1504","TN","507","Jackson/West Tennessee CoC",2050,675,1375,915,448,467,410,195,215,2010,NA,NA,NA,NA,NA,NA,NA,NA
"1505","TN","509","Appalachian Regional CoC",840,641,199,97,83,14,30,27,3,2010,NA,NA,NA,NA,NA,NA,NA,NA
"1506","TN","510","Murfreesboro/Rutherford County CoC",219,115,104,67,53,14,17,13,4,2010,NA,NA,NA,NA,NA,NA,NA,NA
"1507","TN","512","Morristown/Blount, Sevier, Campbell, Cocke Counties CoC",842,656,186,263,229,34,78,68,10,2010,NA,NA,NA,NA,NA,NA,NA,NA
"1508","TX","500","San Antonio/Bexar County CoC",3291,1674,1617,878,840,38,291,279,12,2010,NA,NA,NA,NA,NA,NA,NA,NA
"1509","TX","503","Austin/Travis County CoC",2087,1254,833,601,601,0,196,196,0,2010,NA,NA,NA,NA,NA,NA,NA,NA
"1510","TX","600","Dallas City & County, Irving CoC",3710,3509,201,1307,1307,0,433,433,0,2010,NA,NA,NA,NA,NA,NA,NA,NA
"1511","TX","601","Fort Worth, Arlington/Tarrant County CoC",2181,1986,195,882,882,0,281,281,0,2010,NA,NA,NA,NA,NA,NA,NA,NA
"1512","TX","603","El Paso City & County CoC",1260,964,296,492,486,6,159,156,3,2010,NA,NA,NA,NA,NA,NA,NA,NA
"1513","TX","604","Waco/McLennan County CoC",312,226,86,81,75,6,24,23,1,2010,NA,NA,NA,NA,NA,NA,NA,NA
"1514","TX","607","Texas Balance of State CoC",14827,4366,10461,4685,1895,2790,1745,637,1108,2010,NA,NA,NA,NA,NA,NA,NA,NA
"1515","TX","611","Amarillo CoC",578,547,31,168,168,0,48,48,0,2010,NA,NA,NA,NA,NA,NA,NA,NA
"1516","TX","624","Wichita Falls/Wise, Palo Pinto, Wichita, Archer Counties CoC",242,235,7,27,27,0,11,11,0,2010,NA,NA,NA,NA,NA,NA,NA,NA
"1517","TX","700","Houston, Pasadena, Conroe/Harris, Ft. Bend, Montgomery, Counties CoC",6368,4249,2119,1880,1626,254,781,717,64,2010,NA,NA,NA,NA,NA,NA,NA,NA
"1518","TX","701","Bryan, College Station/Brazos Valley CoC",265,181,84,42,35,7,18,15,3,2010,NA,NA,NA,NA,NA,NA,NA,NA
"1519","UT","500","Salt Lake City & County CoC",1968,1739,229,777,774,3,227,226,1,2010,NA,NA,NA,NA,NA,NA,NA,NA
"1520","UT","503","Utah Balance of State CoC",952,820,132,487,467,20,145,139,6,2010,NA,NA,NA,NA,NA,NA,NA,NA
"1521","UT","504","Provo/Mountainland CoC",364,163,201,94,88,6,32,30,2,2010,NA,NA,NA,NA,NA,NA,NA,NA
"1522","VA","500","Richmond/Henrico, Chesterfield, Hanover Counties CoC",1012,962,50,212,212,0,78,78,0,2010,NA,NA,NA,NA,NA,NA,NA,NA
"1523","VA","501","Norfolk/Chesapeake, Suffolk, Isle of Wight, Southampton Counties CoC",625,541,84,197,189,8,58,56,2,2010,NA,NA,NA,NA,NA,NA,NA,NA
"1524","VA","502","Roanoke City & County, Salem CoC",518,500,18,123,123,0,45,45,0,2010,NA,NA,NA,NA,NA,NA,NA,NA
"1525","VA","503","Virginia Beach CoC",517,435,82,266,266,0,79,79,0,2010,NA,NA,NA,NA,NA,NA,NA,NA
"1526","VA","504","Charlottesville CoC",228,201,27,60,52,8,18,16,2,2010,NA,NA,NA,NA,NA,NA,NA,NA
"1527","VA","505","Newport News, Hampton/Virginia Peninsula CoC",607,573,34,159,159,0,51,51,0,2010,NA,NA,NA,NA,NA,NA,NA,NA
"1528","VA","507","Portsmouth CoC",210,178,32,63,63,0,22,22,0,2010,NA,NA,NA,NA,NA,NA,NA,NA
"1529","VA","508","Lynchburg CoC",255,211,44,122,122,0,44,44,0,2010,NA,NA,NA,NA,NA,NA,NA,NA
"1530","VA","513","Harrisburg, Winchester/Western Virginia CoC",448,359,89,217,179,38,50,40,10,2010,NA,NA,NA,NA,NA,NA,NA,NA
"1531","VA","514","Fredericksburg/Spotsylvania, Stafford Counties CoC",288,160,128,64,59,5,22,20,2,2010,NA,NA,NA,NA,NA,NA,NA,NA
"1532","VA","521","Virginia Balance of State CoC",1261,801,460,629,496,133,213,165,48,2010,NA,NA,NA,NA,NA,NA,NA,NA
"1533","VA","600","Arlington County CoC",535,312,223,184,184,0,61,61,0,2010,NA,NA,NA,NA,NA,NA,NA,NA
"1534","VA","601","Fairfax County CoC",1552,1412,140,892,892,0,263,263,0,2010,NA,NA,NA,NA,NA,NA,NA,NA
"1535","VA","602","Loudoun County CoC",157,121,36,86,77,9,25,23,2,2010,NA,NA,NA,NA,NA,NA,NA,NA
"1536","VA","603","Alexandria CoC",359,321,38,151,151,0,52,52,0,2010,NA,NA,NA,NA,NA,NA,NA,NA
"1537","VA","604","Prince William County CoC",508,352,156,317,249,68,100,74,26,2010,NA,NA,NA,NA,NA,NA,NA,NA
"1538","VT","500","Vermont Balance of State CoC",607,528,79,179,167,12,63,59,4,2010,NA,NA,NA,NA,NA,NA,NA,NA
"1539","VT","501","Burlington/Chittenden County CoC",613,550,63,244,239,5,104,103,1,2010,NA,NA,NA,NA,NA,NA,NA,NA
"1540","WA","500","Seattle/King County CoC",9022,6222,2800,3414,3373,41,1064,1047,17,2010,NA,NA,NA,NA,NA,NA,NA,NA
"1541","WA","501","Washington Balance of State CoC",7685,5262,2423,4053,3210,843,1266,1011,255,2010,NA,NA,NA,NA,NA,NA,NA,NA
"1542","WA","502","Spokane City & County CoC",1242,1070,172,583,560,23,134,127,7,2010,NA,NA,NA,NA,NA,NA,NA,NA
"1543","WA","503","Tacoma, Lakewood/Pierce County CoC",1807,1637,170,1110,1093,17,333,327,6,2010,NA,NA,NA,NA,NA,NA,NA,NA
"1544","WA","504","Everett/Snohomish County CoC",2018,1403,615,1213,1049,164,399,356,43,2010,NA,NA,NA,NA,NA,NA,NA,NA
"1545","WA","508","Vancouver/Clark County CoC",1104,895,209,604,499,105,192,155,37,2010,NA,NA,NA,NA,NA,NA,NA,NA
"1546","WI","500","Wisconsin Balance of State CoC",3992,3207,785,2404,1872,532,811,621,190,2010,NA,NA,NA,NA,NA,NA,NA,NA
"1547","WI","501","Milwaukee City & County CoC",1537,1317,220,563,491,72,173,149,24,2010,NA,NA,NA,NA,NA,NA,NA,NA
"1548","WI","502","Racine City & County CoC",236,230,6,78,76,2,17,16,1,2010,NA,NA,NA,NA,NA,NA,NA,NA
"1549","WI","503","Madison/Dane County CoC",568,499,69,248,216,32,79,70,9,2010,NA,NA,NA,NA,NA,NA,NA,NA
"1550","WV","500","Wheeling, Weirton Area CoC",197,149,48,38,29,9,12,9,3,2010,NA,NA,NA,NA,NA,NA,NA,NA
"1551","WV","501","Huntington/Cabell, Wayne Counties CoC",286,243,43,92,92,0,30,30,0,2010,NA,NA,NA,NA,NA,NA,NA,NA
"1552","WV","503","Charleston/Kanawha, Putnam, Boone, Clay Counties CoC",406,374,32,120,120,0,46,46,0,2010,NA,NA,NA,NA,NA,NA,NA,NA
"1553","WV","508","West Virginia Balance of State CoC",1375,758,617,487,235,252,157,84,73,2010,NA,NA,NA,NA,NA,NA,NA,NA
"1554","WY","500","Wyoming Statewide CoC",579,515,64,252,246,6,90,88,2,2010,NA,NA,NA,NA,NA,NA,NA,NA
"1555",NA,NA,"Total",637077,403543,233534,241937,191325,50612,79442,62305,17137,2010,NA,NA,NA,NA,NA,NA,NA,NA
"1556","AK","500","Anchorage CoC",1223,1082,141,429,405,24,138,131,7,2011,129,109,20,199,168,31,NA,NA
"1557","AK","501","Alaska Balance of State CoC",905,678,227,413,313,100,139,109,30,2011,124,85,39,89,68,21,NA,NA
"1558","AL","500","Birmingham/Jefferson, St. Clair, Shelby Counties CoC",1950,1024,926,505,329,176,175,99,76,2011,564,149,415,281,110,171,NA,NA
"1559","AL","501","Mobile City & County/Baldwin County CoC",718,407,311,176,176,0,72,72,0,2011,65,7,58,60,19,41,NA,NA
"1560","AL","502","Florence/Northwest Alabama CoC",244,234,10,25,25,0,9,9,0,2011,6,0,6,5,1,4,NA,NA
"1561","AL","503","Huntsville/North Alabama CoC",656,481,175,167,130,37,51,38,13,2011,244,164,80,69,59,10,NA,NA
"1562","AL","504","Montgomery City & County CoC",433,287,146,100,89,11,30,27,3,2011,84,12,72,59,34,25,NA,NA
"1563","AL","505","Gadsden/Northeast Alabama CoC",495,353,142,81,43,38,22,10,12,2011,73,32,41,15,7,8,NA,NA
"1564","AL","506","Tuscaloosa City & County CoC",265,236,29,8,8,0,3,3,0,2011,37,33,4,107,107,0,NA,NA
"1565","AL","507","Alabama Balance of State CoC",797,727,70,171,167,4,72,70,2,2011,41,21,20,63,50,13,NA,NA
"1566","AR","500","Little Rock/Central Arkansas CoC",1276,789,487,182,182,0,63,63,0,2011,202,155,47,303,193,110,NA,NA
"1567","AR","501","Fayetteville/Northwest Arkansas CoC",238,199,39,110,102,8,43,40,3,2011,102,66,36,39,33,6,NA,NA
"1568","AR","503","Arkansas  Balance of State  CoC",1026,648,378,239,136,103,104,57,47,2011,217,82,135,65,42,23,NA,NA
"1569","AR","504","Delta Hills CoC",790,72,718,349,23,326,122,10,112,2011,86,25,61,4,0,4,NA,NA
"1570","AR","505","Southeast Arkansas CoC",94,94,0,39,39,0,17,17,0,2011,0,0,0,0,0,0,NA,NA
"1571","AR","507","Eastern Arkansas CoC",NA,NA,NA,NA,NA,NA,NA,NA,NA,2011,NA,NA,NA,NA,NA,NA,NA,NA
"1572","AR","512","Boone, Baxter, Marion, Newton Counties CoC",NA,NA,NA,NA,NA,NA,NA,NA,NA,2011,NA,NA,NA,NA,NA,NA,NA,NA
"1573","AZ","500","Arizona Balance of State CoC",2047,1318,729,1020,587,433,285,183,102,2011,466,199,267,320,207,113,NA,NA
"1574","AZ","501","Tucson/Pima County CoC",2626,1902,724,843,801,42,271,256,15,2011,725,526,199,454,304,150,NA,NA
"1575","AZ","502","Phoenix, Mesa/Maricopa County CoC",5831,4082,1749,2238,2230,8,683,680,3,2011,1092,303,789,754,507,247,NA,NA
"1576","CA","500","San Jose/Santa Clara City & County CoC",7067,1898,5169,617,561,56,232,214,18,2011,2555,225,2330,667,152,515,NA,NA
"1577","CA","501","San Francisco CoC",5669,2298,3371,635,540,95,233,193,40,2011,1738,628,1110,919,489,430,NA,NA
"1578","CA","502","Oakland, Berkeley/Alameda County CoC",4178,1966,2212,1136,996,140,376,352,24,2011,1214,230,984,488,143,345,NA,NA
"1579","CA","503","Sacramento City & County CoC",2376,1421,955,604,599,5,203,201,2,2011,353,111,242,297,116,181,NA,NA
"1580","CA","504","Santa Rosa, Petaluma/Sonoma County CoC",4541,1175,3366,567,527,40,190,178,12,2011,1018,63,955,404,77,327,NA,NA
"1581","CA","505","Richmond/Contra Costa County CoC",2415,925,1490,467,464,3,154,153,1,2011,743,210,533,77,69,8,NA,NA
"1582","CA","506","Salinas/Monterey, San Benito Counties CoC",2699,788,1911,584,430,154,153,122,31,2011,831,52,779,296,52,244,NA,NA
"1583","CA","507","Marin County CoC",862,509,353,236,230,6,86,84,2,2011,224,86,138,68,32,36,NA,NA
"1584","CA","508","Watsonville/Santa Cruz City & County CoC",2771,646,2125,374,314,60,115,100,15,2011,1005,58,947,276,31,245,NA,NA
"1585","CA","509","Mendocino County CoC",1456,142,1314,104,44,60,35,15,20,2011,370,58,312,92,18,74,NA,NA
"1586","CA","510","Turlock, Modesto/Stanislaus County CoC",1434,643,791,447,255,192,130,81,49,2011,236,96,140,73,43,30,NA,NA
"1587","CA","511","Stockton/San Joaquin County CoC",2540,2293,247,1002,977,25,313,306,7,2011,323,212,111,112,92,20,NA,NA
"1588","CA","512","Daly/San Mateo County CoC",1926,764,1162,501,368,133,148,111,37,2011,486,10,476,324,177,147,NA,NA
"1589","CA","513","Visalia/Kings, Tulare Counties CoC",804,457,347,164,125,39,59,42,17,2011,134,50,84,36,3,33,NA,NA
"1590","CA","514","Fresno City & County/Madera County CoC",5135,1313,3822,1425,827,598,580,327,253,2011,836,49,787,619,77,542,NA,NA
"1591","CA","515","Roseville, Rocklin/Placer, Nevada Counties CoC",821,466,355,277,239,38,87,74,13,2011,149,27,122,74,37,37,NA,NA
"1592","CA","516","Redding/Shasta, Siskiyou, Lassen, Plumas, Del Norte, Modoc, Sierra Counties CoC",527,356,171,124,101,23,35,25,10,2011,93,38,55,46,38,8,NA,NA
"1593","CA","517","Napa City & County CoC",230,138,92,59,50,9,19,15,4,2011,52,18,34,18,9,9,NA,NA
"1594","CA","518","Vallejo/Solano County CoC",569,334,235,193,144,49,69,48,21,2011,140,140,0,41,27,14,NA,NA
"1595","CA","519","Chico, Paradise/Butte County CoC",897,357,540,144,117,27,45,35,10,2011,261,24,237,117,47,70,NA,NA
"1596","CA","520","Merced City & County CoC",486,187,299,26,26,0,9,9,0,2011,265,62,203,43,9,34,NA,NA
"1597","CA","521","Davis, Woodland/Yolo County CoC",468,205,263,118,101,17,36,31,5,2011,203,36,167,50,14,36,NA,NA
"1598","CA","522","Humboldt County CoC",861,407,454,262,209,53,105,86,19,2011,387,234,153,99,20,79,NA,NA
"1599","CA","523","Colusa, Glenn, Trinity Counties CoC",322,183,139,122,90,32,43,32,11,2011,106,38,68,28,17,11,NA,NA
"1600","CA","524","Yuba City & County/Sutter County CoC",649,355,294,241,156,85,70,43,27,2011,51,19,32,26,13,13,NA,NA
"1601","CA","525","El Dorado County CoC",170,133,37,63,57,6,22,19,3,2011,19,12,7,2,1,1,NA,NA
"1602","CA","526","Amador, Calaveras, Mariposa, Tuolumne Counties CoC",406,137,269,217,109,108,65,30,35,2011,102,22,80,25,7,18,NA,NA
"1603","CA","528","Del Norte County CoC",448,27,421,132,16,116,38,8,30,2011,384,0,384,10,0,10,NA,NA
"1604","CA","600","Los Angeles City & County CoC",34622,16882,17740,9218,7254,1964,3035,2483,552,2011,9640,3083,6557,6281,3243,3038,NA,NA
"1605","CA","601","San Diego City and County CoC",9436,3980,5456,1673,1477,196,564,480,84,2011,2348,174,2174,1649,756,893,NA,NA
"1606","CA","602","Santa Ana, Anaheim/Orange County CoC",6939,2667,4272,1708,1686,22,574,567,7,2011,1670,81,1589,856,96,760,NA,NA
"1607","CA","603","Santa Maria/Santa Barbara County CoC",1698,830,868,321,278,43,112,98,14,2011,558,172,386,158,70,88,NA,NA
"1608","CA","604","Bakersfield/Kern County CoC",1439,606,833,203,159,44,69,52,17,2011,441,48,393,173,79,94,NA,NA
"1609","CA","606","Long Beach CoC",3164,961,2203,568,301,267,181,95,86,2011,1101,117,984,658,349,309,NA,NA
"1610","CA","607","Pasadena CoC",1216,453,763,194,155,39,75,65,10,2011,425,105,320,89,13,76,NA,NA
"1611","CA","608","Riverside City & County CoC",6203,1113,5090,548,517,31,220,210,10,2011,2530,79,2451,890,76,814,NA,NA
"1612","CA","609","San Bernardino City & County CoC",2825,1133,1692,909,583,326,189,100,89,2011,240,60,180,246,80,166,NA,NA
"1613","CA","611","Oxnard, San Buenaventura/Ventura County CoC",1810,830,980,351,238,113,109,74,35,2011,679,150,529,140,31,109,NA,NA
"1614","CA","612","Glendale CoC",412,291,121,115,115,0,42,42,0,2011,107,94,13,39,20,19,NA,NA
"1615","CA","613","Imperial County CoC",508,194,314,110,110,0,39,39,0,2011,16,0,16,6,6,0,NA,NA
"1616","CA","614","San Luis Obispo County CoC",2129,228,1901,405,118,287,162,54,108,2011,556,68,488,271,60,211,NA,NA
"1617","CO","500","Colorado Balance of State CoC",9283,1015,8268,7668,720,6948,1918,181,1737,2011,729,31,698,572,77,495,NA,NA
"1618","CO","503","Metropolitan Denver CoC",4809,4277,532,2609,2491,118,924,883,41,2011,588,422,166,1322,1188,134,NA,NA
"1619","CO","504","Colorado Springs/El Paso County CoC",1024,854,170,293,284,9,93,90,3,2011,178,96,82,180,116,64,NA,NA
"1620","CT","503","Bridgeport, Stamford, Norwalk/Fairfield County CoC",1005,844,161,268,256,12,90,85,5,2011,277,204,73,88,74,14,NA,NA
"1621","CT","505","Connecticut Balance of State CoC",3451,2917,534,1117,1088,29,392,380,12,2011,822,565,257,355,322,33,NA,NA
"1622","DE","500","Delaware Statewide CoC",1035,1013,22,372,372,0,116,116,0,2011,70,59,11,55,53,2,NA,NA
"1623","FL","500","Sarasota, Bradenton/Manatee, Sarasota Counties CoC",1152,895,257,230,207,23,105,97,8,2011,222,72,150,64,23,41,NA,NA
"1624","FL","501","Tampa/Hillsborough County CoC",7336,889,6447,2868,312,2556,812,102,710,2011,679,48,631,792,97,695,NA,NA
"1625","FL","502","St. Petersburg, Clearwater, Largo/Pinellas County CoC",3890,1870,2020,1201,401,800,373,174,199,2011,466,163,303,431,313,118,NA,NA
"1626","FL","503","Lakeland, Winterhaven/Polk County CoC",1100,498,602,167,167,0,53,53,0,2011,32,11,21,78,46,32,NA,NA
"1627","FL","504","Daytona Beach, Daytona/Volusia, Flagler Counties CoC",2210,535,1675,195,195,0,61,61,0,2011,202,3,199,153,59,94,NA,NA
"1628","FL","505","Fort Walton Beach/Okaloosa, Walton Counties CoC",2764,475,2289,1937,110,1827,546,39,507,2011,367,183,184,246,124,122,NA,NA
"1629","FL","506","Tallahassee/Leon County CoC",787,728,59,178,178,0,68,68,0,2011,112,94,18,63,60,3,NA,NA
"1630","FL","507","Orlando/Orange, Osceola, Seminole Counties CoC",4515,2127,2388,1380,888,492,437,273,164,2011,2363,567,1796,690,190,500,NA,NA
"1631","FL","508","Gainesville/Alachua, Putnam Counties CoC",1179,439,740,210,114,96,73,40,33,2011,363,76,287,331,197,134,NA,NA
"1632","FL","509","Fort Pierce/St. Lucie, Indian River, Martin Counties CoC",1683,194,1489,1074,149,925,398,51,347,2011,171,43,128,95,8,87,NA,NA
"1633","FL","510","Jacksonville-Duval, Clay Counties CoC",3025,1593,1432,648,648,0,220,220,0,2011,1104,756,348,345,186,159,NA,NA
"1634","FL","511","Pensacola/Escambia, Santa Rosa Counties CoC",733,455,278,143,116,27,43,34,9,2011,200,71,129,158,52,106,NA,NA
"1635","FL","512","St. Johns County CoC",1391,190,1201,387,126,261,99,41,58,2011,75,0,75,41,6,35,NA,NA
"1636","FL","513","Palm Bay, Melbourne/Brevard County CoC",1907,690,1217,609,386,223,281,184,97,2011,136,71,65,355,126,229,NA,NA
"1637","FL","514","Ocala/Marion County CoC",1032,432,600,71,65,6,22,19,3,2011,122,37,85,144,23,121,NA,NA
"1638","FL","515","Panama City/Bay, Jackson Counties CoC",411,296,115,91,71,20,39,31,8,2011,68,46,22,46,24,22,NA,NA
"1639","FL","517","Hendry, Hardee, Highlands Counties CoC",1319,114,1205,760,0,760,376,0,376,2011,412,0,412,10,0,10,NA,NA
"1640","FL","518","Columbia, Hamilton, Lafayette, Suwannee Counties CoC",1179,83,1096,387,31,356,155,13,142,2011,236,7,229,244,27,217,NA,NA
"1641","FL","519","Pasco County CoC",4502,343,4159,3164,172,2992,1266,69,1197,2011,1830,372,1458,140,65,75,NA,NA
"1642","FL","520","Citrus, Hernando, Lake, Sumter Counties CoC",1715,330,1385,523,127,396,210,47,163,2011,23,10,13,35,30,5,NA,NA
"1643","FL","600","Miami-Dade County CoC",3817,3028,789,1349,1349,0,385,385,0,2011,529,300,229,308,218,90,NA,NA
"1644","FL","601","Ft Lauderdale/Broward County CoC",3801,2533,1268,554,523,31,145,133,12,2011,816,400,416,393,172,221,NA,NA
"1645","FL","602","Punta Gorda/Charlotte County CoC",828,192,636,90,36,54,37,10,27,2011,193,27,166,100,44,56,NA,NA
"1646","FL","603","Ft Myers, Cape Coral/Lee County CoC",969,513,456,219,82,137,69,34,35,2011,206,91,115,88,51,37,NA,NA
"1647","FL","604","Monroe County CoC",904,346,558,106,40,66,41,16,25,2011,261,57,204,96,56,40,NA,NA
"1648","FL","605","West Palm Beach/Palm Beach County CoC",2148,751,1397,483,318,165,140,102,38,2011,423,58,365,181,71,110,NA,NA
"1649","FL","606","Naples/Collier County CoC",390,285,105,79,79,0,29,29,0,2011,27,14,13,17,8,9,NA,NA
"1650","GA","500","Atlanta CoC",6805,4427,2378,1073,1031,42,365,350,15,2011,2372,1745,627,1237,803,434,NA,NA
"1651","GA","501","Georgia Balance of State CoC",11168,2313,8855,3179,1602,1577,1066,567,499,2011,1761,145,1616,758,49,709,NA,NA
"1652","GA","503","Athens-Clarke County CoC",407,278,129,111,111,0,31,31,0,2011,86,35,51,27,16,11,NA,NA
"1653","GA","504","Augusta-Richmond County CoC",497,492,5,206,203,3,55,54,1,2011,82,80,2,69,69,0,NA,NA
"1654","GA","505","Columbus-Muscogee/Russell County CoC",486,261,225,108,68,40,36,23,13,2011,105,57,48,64,39,25,NA,NA
"1655","GA","506","Marietta/Cobb County CoC",370,321,49,182,179,3,60,59,1,2011,37,7,30,40,20,20,NA,NA
"1656","GA","507","Savannah/Chatham County CoC",1242,631,611,141,141,0,48,48,0,2011,138,43,95,48,29,19,NA,NA
"1657","HI","500","Hawaii Balance of State CoC",1954,720,1234,758,497,261,217,136,81,2011,366,40,326,173,25,148,NA,NA
"1658","HI","501","Honolulu City and County CoC",4234,2912,1322,2235,2058,177,558,514,44,2011,569,76,493,332,185,147,NA,NA
"1659","IA","500","Sioux City/Dakota, Woodbury Counties CoC",366,337,29,199,188,11,66,61,5,2011,106,91,15,25,21,4,NA,NA
"1660","IA","501","Iowa Balance of State CoC",1782,1754,28,1005,1005,0,318,318,0,2011,114,103,11,121,116,5,NA,NA
"1661","IA","502","Des Moines/Polk County CoC",986,922,64,302,302,0,88,88,0,2011,131,90,41,121,118,3,NA,NA
"1662","ID","500","Boise/Ada County CoC",838,741,97,208,206,2,76,75,1,2011,139,114,25,135,120,15,NA,NA
"1663","ID","501","Idaho Balance of State CoC",1361,844,517,681,538,143,221,181,40,2011,169,35,134,115,49,66,NA,NA
"1664","IL","500","McHenry County CoC",182,179,3,69,69,0,25,25,0,2011,33,33,0,51,51,0,NA,NA
"1665","IL","501","Rockford/Winnebago, Boone Counties CoC",580,451,129,225,179,46,82,64,18,2011,243,191,52,71,65,6,NA,NA
"1666","IL","502","Waukegan, North Chicago/Lake County CoC",464,461,3,195,195,0,78,78,0,2011,64,64,0,60,60,0,NA,NA
"1667","IL","503","Champaign, Urbana, Rantoul/Champaign County CoC",231,205,26,144,135,9,69,65,4,2011,52,29,23,23,23,0,NA,NA
"1668","IL","504","Madison County CoC",256,207,49,158,151,7,47,45,2,2011,19,2,17,6,3,3,NA,NA
"1669","IL","506","Joliet, Bolingbrook/Will County CoC",353,320,33,162,162,0,54,54,0,2011,46,34,12,20,18,2,NA,NA
"1670","IL","507","Peoria, Pekin/Fulton, Tazewell, Peoria, Woodford Counties CoC",313,304,9,119,116,3,40,39,1,2011,74,73,1,26,25,1,NA,NA
"1671","IL","508","East St. Louis, Belleville/St. Clair County CoC",370,185,185,194,131,63,69,46,23,2011,124,63,61,31,18,13,NA,NA
"1672","IL","509","Dekalb City & County CoC",160,117,43,97,72,25,27,20,7,2011,4,4,0,0,0,0,NA,NA
"1673","IL","510","Chicago CoC",6635,4913,1722,2374,2313,61,766,736,30,2011,1155,432,723,500,250,250,NA,NA
"1674","IL","511","Cook County CoC",1257,1024,233,535,528,7,174,172,2,2011,228,116,112,118,91,27,NA,NA
"1675","IL","512","Bloomington/Central Illinois CoC",635,419,216,247,120,127,86,47,39,2011,75,64,11,53,53,0,NA,NA
"1676","IL","513","Springfield/Sangamon County CoC",227,227,0,90,90,0,26,26,0,2011,70,70,0,19,19,0,NA,NA
"1677","IL","514","DuPage County CoC",676,643,33,372,369,3,125,124,1,2011,147,132,15,18,17,1,NA,NA
"1678","IL","515","South Central Illinois CoC",160,160,0,136,136,0,55,55,0,2011,10,10,0,1,1,0,NA,NA
"1679","IL","516","Decatur/Macon County CoC",206,165,41,100,84,16,34,30,4,2011,41,21,20,18,15,3,NA,NA
"1680","IL","517","Aurora, Elgin/Kane County CoC",444,401,43,117,110,7,38,35,3,2011,110,101,9,29,25,4,NA,NA
"1681","IL","518","Rock Island, Moline/Northwestern Illinois CoC",313,285,28,164,150,14,54,50,4,2011,30,29,1,18,18,0,NA,NA
"1682","IL","519","West Central Illinois CoC",160,137,23,116,99,17,37,32,5,2011,15,9,6,4,2,2,NA,NA
"1683","IL","520","Southern Illinois CoC",387,286,101,222,188,34,71,61,10,2011,23,6,17,15,11,4,NA,NA
"1684","IN","502","Indiana Balance of State CoC",4609,4077,532,2013,1900,113,637,598,39,2011,434,305,129,452,394,58,NA,NA
"1685","IN","503","Indianapolis CoC",1587,1473,114,394,394,0,121,121,0,2011,168,120,48,262,244,18,NA,NA
"1686","KS","502","Wichita/Sedgwick County CoC",634,526,108,180,175,5,52,50,2,2011,141,91,50,68,47,21,NA,NA
"1687","KS","503","Topeka/Shawnee County CoC",336,315,21,145,141,4,40,38,2,2011,101,95,6,43,41,2,NA,NA
"1688","KS","505","Overland Park, Shawnee/Johnson County CoC",315,247,68,260,215,45,75,64,11,2011,4,3,1,6,4,2,NA,NA
"1689","KS","507","Kansas Balance of State CoC",1023,962,61,427,417,10,140,136,4,2011,70,55,15,214,202,12,NA,NA
"1690","KY","500","Kentucky Balance of State CoC",2834,2133,701,1338,1165,173,403,352,51,2011,310,182,128,160,117,43,NA,NA
"1691","KY","501","Louisville-Jefferson County CoC",1628,1536,92,386,382,4,134,133,1,2011,261,201,60,314,303,11,NA,NA
"1692","KY","502","Lexington-Fayette County CoC",1572,1514,58,468,466,2,194,193,1,2011,213,194,19,162,159,3,NA,NA
"1693","LA","500","Lafayette/Acadiana CoC",577,485,92,194,194,0,67,67,0,2011,35,14,21,39,34,5,NA,NA
"1694","LA","502","Shreveport, Bossier/Northwest Louisiana CoC",733,577,156,262,262,0,81,81,0,2011,94,14,80,162,122,40,NA,NA
"1695","LA","503","New Orleans/Jefferson Parish CoC",6687,1313,5374,562,464,98,204,172,32,2011,4087,23,4064,515,95,420,NA,NA
"1696","LA","505","Monroe/Northeast Louisiana CoC",227,197,30,111,111,0,38,38,0,2011,30,24,6,12,8,4,NA,NA
"1697","LA","506","Slidell/Southeast Louisiana CoC",281,241,40,106,86,20,33,28,5,2011,29,23,6,58,54,4,NA,NA
"1698","LA","507","Alexandria/Central Louisiana CoC",208,173,35,46,46,0,18,18,0,2011,27,11,16,21,9,12,NA,NA
"1699","LA","509","Louisiana Balance of State CoC",578,419,159,69,45,24,28,20,8,2011,131,56,75,143,121,22,NA,NA
"1700","MA","500","Boston CoC",5476,5294,182,2926,2926,0,987,987,0,2011,618,534,84,426,404,22,NA,NA
"1701","MA","501","Holyoke/Franklin, Hampden, Hampshire Counties CoC",1541,1504,37,1054,1054,0,372,372,0,2011,134,103,31,191,189,2,NA,NA
"1702","MA","502","Lynn CoC",531,502,29,380,380,0,135,135,0,2011,149,140,9,15,15,0,NA,NA
"1703","MA","503","Cape Cod Islands CoC",480,353,127,211,185,26,80,72,8,2011,111,49,62,42,35,7,NA,NA
"1704","MA","504","Springfield/Hampden County CoC",1025,1020,5,734,734,0,248,248,0,2011,184,180,4,30,27,3,NA,NA
"1705","MA","505","New Bedford CoC",351,342,9,94,94,0,36,36,0,2011,12,9,3,50,50,0,NA,NA
"1706","MA","506","Worcester City & County CoC",1315,1264,51,919,916,3,309,308,1,2011,34,12,22,132,126,6,NA,NA
"1707","MA","507","Pittsfield/Berkshire, Franklin, Hampshire Counties CoC",192,170,22,41,39,2,16,15,1,2011,54,47,7,70,70,0,NA,NA
"1708","MA","508","Lowell CoC",589,546,43,380,380,0,124,124,0,2011,35,22,13,74,72,2,NA,NA
"1709","MA","509","Cambridge CoC",471,419,52,125,125,0,44,44,0,2011,170,124,46,41,36,5,NA,NA
"1710","MA","510","Gloucester, Haverhill, Salem/Essex County CoC",886,848,38,632,632,0,202,202,0,2011,151,130,21,74,73,1,NA,NA
"1711","MA","511","Quincy, Brockton, Weymouth, Plymouth City and County CoC",1468,1450,18,1068,1068,0,365,365,0,2011,197,183,14,96,95,1,NA,NA
"1712","MA","515","Fall River CoC",288,277,11,188,188,0,41,41,0,2011,45,38,7,6,3,3,NA,NA
"1713","MA","516","Massachusetts Balance of State CoC",1690,1651,39,1362,1362,0,493,493,0,2011,122,109,13,15,13,2,NA,NA
"1714","MA","517","Somerville CoC",137,132,5,57,57,0,22,22,0,2011,28,23,5,1,1,0,NA,NA
"1715","MA","519","Attleboro, Taunton/Bristol County CoC",224,189,35,149,149,0,57,57,0,2011,17,8,9,5,1,4,NA,NA
"1716","MD","500","Cumberland/Allegany County CoC",123,85,38,59,39,20,20,14,6,2011,22,10,12,9,6,3,NA,NA
"1717","MD","501","Baltimore CoC",4094,2299,1795,934,521,413,323,166,157,2011,519,211,308,342,316,26,NA,NA
"1718","MD","502","Harford County CoC",243,225,18,121,121,0,34,34,0,2011,36,28,8,9,9,0,NA,NA
"1719","MD","503","Annapolis/Anne Arundel County CoC",382,312,70,153,153,0,52,52,0,2011,53,29,24,27,21,6,NA,NA
"1720","MD","504","Howard County CoC",189,133,56,95,95,0,30,30,0,2011,52,8,44,12,6,6,NA,NA
"1721","MD","505","Baltimore County CoC",881,494,387,409,309,100,132,101,31,2011,191,102,89,70,26,44,NA,NA
"1722","MD","506","Carroll County CoC",179,157,22,67,67,0,24,24,0,2011,25,22,3,6,6,0,NA,NA
"1723","MD","507","Cecil County CoC",220,196,24,54,41,13,18,15,3,2011,28,23,5,101,100,1,NA,NA
"1724","MD","508","Charles, Calvert, St.Mary's Counties CoC",1153,348,805,897,185,712,362,67,295,2011,200,82,118,9,3,6,NA,NA
"1725","MD","509","Frederick City & County CoC",248,204,44,111,111,0,38,38,0,2011,88,49,39,7,5,2,NA,NA
"1726","MD","510","Garrett County CoC",35,33,2,0,0,0,0,0,0,2011,0,0,0,0,0,0,NA,NA
"1727","MD","511","Mid-Shore Regional CoC",85,76,9,31,28,3,10,9,1,2011,12,12,0,1,1,0,NA,NA
"1728","MD","512","Hagerstown/Washington County CoC",210,134,76,123,68,55,36,20,16,2011,42,33,9,14,11,3,NA,NA
"1729","MD","513","Wicomico, Somerset, Worcester Counties CoC",253,215,38,74,74,0,25,25,0,2011,44,22,22,33,26,7,NA,NA
"1730","MD","600","Prince George's County CoC",772,670,102,344,344,0,106,106,0,2011,140,68,72,15,14,1,NA,NA
"1731","MD","601","Montgomery County CoC",1141,915,226,383,383,0,128,128,0,2011,348,199,149,41,27,14,NA,NA
"1732","ME","500","Maine Statewide CoC",2447,2418,29,1263,1261,2,427,426,1,2011,212,202,10,127,121,6,NA,NA
"1733","MI","500","Michigan Balance of State CoC",2499,2080,419,1447,1311,136,447,404,43,2011,117,85,32,63,40,23,NA,NA
"1734","MI","501","Detroit CoC",3138,2785,353,737,737,0,265,265,0,2011,684,577,107,385,352,33,NA,NA
"1735","MI","502","Dearborn, Dearborn Heights, Westland/Wayne County CoC",482,463,19,350,346,4,101,99,2,2011,16,12,4,29,28,1,NA,NA
"1736","MI","503","St. Clair Shores, Warren/Macomb County CoC",656,350,306,164,140,24,69,57,12,2011,146,72,74,23,15,8,NA,NA
"1737","MI","504","Pontiac, Royal Oak/Oakland County CoC",713,476,237,194,186,8,65,62,3,2011,29,24,5,9,9,0,NA,NA
"1738","MI","505","Flint/Genesee County CoC",490,329,161,138,132,6,54,51,3,2011,124,57,67,74,25,49,NA,NA
"1739","MI","506","Grand Rapids, Wyoming/Kent County CoC",627,611,16,358,358,0,140,140,0,2011,83,67,16,36,36,0,NA,NA
"1740","MI","507","Portage, Kalamazoo City & County CoC",822,768,54,479,470,9,136,133,3,2011,53,47,6,26,24,2,NA,NA
"1741","MI","508","Lansing, East Lansing/Ingham County CoC",444,374,70,97,85,12,30,25,5,2011,102,86,16,78,72,6,NA,NA
"1742","MI","509","Washtenaw County CoC",469,426,43,165,165,0,51,51,0,2011,73,36,37,50,35,15,NA,NA
"1743","MI","510","Saginaw City & County CoC",390,313,77,147,147,0,47,47,0,2011,57,43,14,28,20,8,NA,NA
"1744","MI","511","Lenawee County CoC",166,152,14,99,87,12,29,27,2,2011,24,24,0,8,8,0,NA,NA
"1745","MI","512","Grand Traverse, Antrim, Leelanau Counties CoC",234,213,21,106,106,0,39,39,0,2011,42,36,6,17,17,0,NA,NA
"1746","MI","513","Marquette, Alger Counties CoC",102,98,4,18,18,0,7,7,0,2011,10,8,2,25,24,1,NA,NA
"1747","MI","514","Battle Creek/Calhoun County CoC",192,136,56,48,46,2,18,17,1,2011,50,32,18,38,12,26,NA,NA
"1748","MI","515","Monroe City & County CoC",121,117,4,40,40,0,13,13,0,2011,11,7,4,5,5,0,NA,NA
"1749","MI","516","Norton Shores, Muskegon City & County CoC",691,459,232,346,257,89,121,93,28,2011,56,11,45,27,19,8,NA,NA
"1750","MI","517","Jackson City & County CoC",246,190,56,123,123,0,48,48,0,2011,31,2,29,27,7,20,NA,NA
"1751","MI","518","Livingston County CoC",135,64,71,70,45,25,24,15,9,2011,23,8,15,2,1,1,NA,NA
"1752","MI","519","Holland/Ottawa County CoC",343,340,3,242,242,0,65,65,0,2011,23,23,0,6,6,0,NA,NA
"1753","MI","523","Eaton County CoC",225,120,105,183,102,81,56,31,25,2011,10,1,9,3,0,3,NA,NA
"1754","MN","500","Minneapolis/Hennepin County CoC",3100,2931,169,1572,1556,16,467,462,5,2011,919,883,36,177,169,8,NA,NA
"1755","MN","501","Saint Paul/Ramsey County CoC",1439,1322,117,805,781,24,263,256,7,2011,380,310,70,73,59,14,NA,NA
"1756","MN","502","Rochester/Southeast Minnesota CoC",361,356,5,249,245,4,68,67,1,2011,73,73,0,15,15,0,NA,NA
"1757","MN","503","Dakota, Anoka, Washington, Scott, Carver Counties",696,618,78,503,479,24,162,154,8,2011,82,49,33,42,37,5,NA,NA
"1758","MN","504","Northeast Minnesota CoC",174,91,83,108,66,42,35,18,17,2011,50,17,33,15,8,7,NA,NA
"1759","MN","505","St. Cloud/Central Minnesota CoC",599,402,197,209,169,40,68,56,12,2011,159,87,72,85,61,24,NA,NA
"1760","MN","506","Northwest Minnesota CoC",252,215,37,165,140,25,51,43,8,2011,31,21,10,6,5,1,NA,NA
"1761","MN","508","Moorhead/West Central Minnesota CoC",263,155,108,147,100,47,44,30,14,2011,85,56,29,10,7,3,NA,NA
"1762","MN","509","Duluth/St.Louis County CoC",494,370,124,249,235,14,84,80,4,2011,83,22,61,18,6,12,NA,NA
"1763","MN","511","Southwest Minnesota CoC",117,107,10,78,78,0,23,23,0,2011,0,0,0,8,4,4,NA,NA
"1764","MO","500","St. Louis County CoC",657,552,105,409,364,45,131,115,16,2011,44,37,7,64,62,2,NA,NA
"1765","MO","501","St.Louis City CoC",1344,1215,129,548,542,6,190,187,3,2011,187,148,39,124,99,25,NA,NA
"1766","MO","503","St. Charles City & County, Lincoln, Warren Counties CoC",1003,626,377,584,392,192,201,130,71,2011,25,10,15,9,5,4,NA,NA
"1767","MO","600","Springfield/Greene, Christian, Webster Counties CoC",591,464,127,258,247,11,96,92,4,2011,82,22,60,30,10,20,NA,NA
"1768","MO","602","Joplin/Jasper, Newton Counties CoC",457,341,116,121,121,0,37,37,0,2011,27,21,6,77,70,7,NA,NA
"1769","MO","603","St. Joseph/Andrew, Buchanan, DeKalb Counties CoC",181,156,25,56,56,0,17,17,0,2011,102,84,18,43,38,5,NA,NA
"1770","MO","604a","Kansas City, Independence, Lee’s Summit/Jackson, Wyandotte Counties, MO & KS",2992,2020,972,1622,1175,447,428,292,136,2011,619,327,292,368,234,134,NA,NA
"1771","MO","606","Missouri Balance of State CoC",1967,1516,451,808,632,176,251,210,41,2011,354,288,66,190,157,33,NA,NA
"1772","MS","500","Jackson/Rankin, Madison Counties CoC",826,390,436,5,5,0,1,1,0,2011,191,34,157,93,54,39,NA,NA
"1773","MS","501","Mississippi Balance of State CoC",951,512,439,419,275,144,124,80,44,2011,199,93,106,57,37,20,NA,NA
"1774","MS","503","Gulf Port/Gulf Coast Regional CoC",529,154,375,57,42,15,16,12,4,2011,81,8,73,55,23,32,NA,NA
"1775","MT","500","Montana Statewide CoC",1768,1216,552,674,580,94,222,192,30,2011,324,149,175,251,135,116,NA,NA
"1776","NC","500","Winston-Salem/Forsyth County CoC",527,476,51,128,128,0,47,47,0,2011,140,123,17,47,37,10,NA,NA
"1777","NC","501","Asheville/Buncombe County CoC",514,452,62,61,61,0,24,24,0,2011,81,42,39,209,200,9,NA,NA
"1778","NC","502","Durham City & County CoC",597,539,58,133,133,0,44,44,0,2011,118,80,38,106,93,13,NA,NA
"1779","NC","503","North Carolina Balance of State CoC",2987,2306,681,1072,942,130,347,310,37,2011,312,138,174,242,150,92,NA,NA
"1780","NC","504","Greensboro, High Point CoC",1024,900,124,276,271,5,91,89,2,2011,108,96,12,81,60,21,NA,NA
"1781","NC","505","Charlotte/Mecklenberg CoC",2847,2532,315,881,881,0,293,293,0,2011,307,239,68,248,242,6,NA,NA
"1782","NC","506","Wilmington/Brunswick, New Hanover, Pender Counties CoC",483,392,91,231,213,18,84,76,8,2011,73,45,28,42,31,11,NA,NA
"1783","NC","507","Raleigh/Wake County CoC",1150,998,152,278,278,0,90,90,0,2011,149,91,58,91,81,10,NA,NA
"1784","NC","509","Gastonia/Cleveland, Gaston, Lincoln Counties CoC",378,131,247,40,25,15,15,11,4,2011,78,4,74,6,1,5,NA,NA
"1785","NC","511","Fayetteville/Cumberland County CoC",1061,285,776,493,193,300,120,45,75,2011,54,27,27,130,34,96,NA,NA
"1786","NC","513","Chapel Hill/Orange County CoC",136,103,33,26,26,0,9,9,0,2011,50,28,22,10,6,4,NA,NA
"1787","NC","516","Northwest North Carolina CoC",1192,131,1061,974,59,915,296,20,276,2011,6,3,3,36,6,30,NA,NA
"1788","ND","500","North Dakota Statewide CoC",603,560,43,207,194,13,60,55,5,2011,75,69,6,124,121,3,NA,NA
"1789","NE","500","Nebraska Balance of State CoC",1121,719,402,599,430,169,187,130,57,2011,110,66,44,39,18,21,NA,NA
"1790","NE","501","Omaha, Council Bluffs CoC",1580,1544,36,416,416,0,169,169,0,2011,281,271,10,207,192,15,NA,NA
"1791","NE","502","Lincoln CoC",847,778,69,323,323,0,77,77,0,2011,111,72,39,64,43,21,NA,NA
"1792","NH","500","New Hampshire Balance of State CoC",808,647,161,386,312,74,140,119,21,2011,151,99,52,36,32,4,NA,NA
"1793","NH","501","Manchester CoC",350,271,79,131,123,8,54,50,4,2011,45,30,15,27,26,1,NA,NA
"1794","NH","502","Nashua/Hillsborough County CoC",311,241,70,132,93,39,49,34,15,2011,30,19,11,63,60,3,NA,NA
"1795","NJ","500","Atlantic City & County CoC",533,447,86,96,86,10,37,32,5,2011,88,66,22,51,43,8,NA,NA
"1796","NJ","501","Bergen County CoC",1521,1494,27,893,890,3,310,309,1,2011,52,42,10,27,23,4,NA,NA
"1797","NJ","502","Burlington County CoC",1035,1008,27,561,555,6,183,180,3,2011,99,95,4,14,12,2,NA,NA
"1798","NJ","503","Camden City & County/Gloucester, Cape May, Cumberland Counties CoC",1427,1230,197,695,636,59,253,230,23,2011,75,55,20,123,106,17,NA,NA
"1799","NJ","504","Newark/Essex County CoC",1505,1418,87,788,779,9,265,262,3,2011,120,111,9,82,73,9,NA,NA
"1800","NJ","506","Jersey City, Bayonne/Hudson County CoC",1536,1427,109,995,963,32,377,367,10,2011,78,54,24,40,30,10,NA,NA
"1801","NJ","507","New Brunswick/Middlesex County CoC",930,838,92,557,529,28,198,184,14,2011,75,69,6,23,19,4,NA,NA
"1802","NJ","508","Monmouth County CoC",559,539,20,312,303,9,103,100,3,2011,66,61,5,15,14,1,NA,NA
"1803","NJ","509","Morris County CoC",446,364,82,116,112,4,46,44,2,2011,54,33,21,16,8,8,NA,NA
"1804","NJ","510","Lakewood Township/Ocean County CoC",545,498,47,202,194,8,73,70,3,2011,31,27,4,14,10,4,NA,NA
"1805","NJ","511","Paterson/Passaic County CoC",847,501,346,363,148,215,99,44,55,2011,51,29,22,77,20,57,NA,NA
"1806","NJ","512","Salem County CoC",80,51,29,45,29,16,17,11,6,2011,6,5,1,3,1,2,NA,NA
"1807","NJ","513","Somerset County CoC",387,385,2,105,105,0,40,40,0,2011,32,32,0,224,224,0,NA,NA
"1808","NJ","514","Trenton/Mercer County CoC",843,792,51,427,416,11,158,154,4,2011,63,55,8,62,54,8,NA,NA
"1809","NJ","515","Elizabeth/Union County CoC",1471,1386,85,887,871,16,303,297,6,2011,45,36,9,27,19,8,NA,NA
"1810","NJ","516","Warren, Sussex, Hunterdon Counties CoC",472,452,20,254,254,0,94,94,0,2011,20,18,2,13,12,1,NA,NA
"1811","NM","500","Albuquerque CoC",1639,1252,387,586,548,38,166,157,9,2011,487,326,161,198,127,71,NA,NA
"1812","NM","501","New Mexico Balance of State CoC",1962,1501,461,769,624,145,264,214,50,2011,630,332,298,166,94,72,NA,NA
"1813","NV","500","Las Vegas/Clark County CoC",8003,3762,4241,890,872,18,304,298,6,2011,1191,116,1075,1169,651,518,NA,NA
"1814","NV","501","Reno, Sparks/Washoe County CoC",850,675,175,214,214,0,52,52,0,2011,100,71,29,65,38,27,NA,NA
"1815","NV","502","Nevada Balance of State CoC",297,108,189,73,56,17,25,18,7,2011,62,9,53,6,3,3,NA,NA
"1816","NY","500","Rochester, Irondequoit, Greece/Monroe County CoC",694,694,0,334,334,0,119,119,0,2011,76,76,0,44,44,0,NA,NA
"1817","NY","501","Elmira/Steuben, Allegany, Livingston, Chemung, Schuyler Counties CoC",297,281,16,72,72,0,25,25,0,2011,20,4,16,44,40,4,NA,NA
"1818","NY","503","Albany City & County CoC",641,608,33,281,281,0,78,78,0,2011,89,62,27,80,76,4,NA,NA
"1819","NY","504","Cattaragus County CoC",40,39,1,26,26,0,9,9,0,2011,2,1,1,4,4,0,NA,NA
"1820","NY","505","Syracuse, Auburn/Onondaga, Oswego, Cayuga Counties CoC",834,810,24,215,206,9,60,58,2,2011,87,79,8,87,84,3,NA,NA
"1821","NY","506","Fulton, Montgomery, Schoharie Counties CoC",60,60,0,40,40,0,11,11,0,2011,0,0,0,0,0,0,NA,NA
"1822","NY","507","Schenectady City & County CoC",358,330,28,127,127,0,44,44,0,2011,57,57,0,10,7,3,NA,NA
"1823","NY","508","Buffalo, Niagara Falls/Erie, Niagara, Orleans, Genesee, Wyoming Counties CoC",1156,968,188,382,368,14,130,124,6,2011,139,65,74,55,42,13,NA,NA
"1824","NY","510","Ithaca/Tompkins County CoC",68,53,15,23,23,0,8,8,0,2011,13,2,11,1,0,1,NA,NA
"1825","NY","511","Binghamton, Union Town/Broome, Otsego, Chenango, Delaware, Cortland, Tioga Count",218,207,11,10,10,0,5,5,0,2011,15,15,0,14,14,0,NA,NA
"1826","NY","512","Troy/Rensselaer County CoC",267,190,77,135,135,0,46,46,0,2011,62,42,20,4,1,3,NA,NA
"1827","NY","513","Wayne, Ontario, Seneca, Yates Counties CoC",111,111,0,37,37,0,15,15,0,2011,9,6,3,37,37,0,NA,NA
"1828","NY","514","Jamestown, Dunkirk/Chautauqua County CoC",57,56,1,34,34,0,14,14,0,2011,4,4,0,0,0,0,NA,NA
"1829","NY","516","Clinton County CoC",118,117,1,15,15,0,7,7,0,2011,12,10,2,7,6,1,NA,NA
"1830","NY","518","Utica, Rome/Oneida, Madison Counties CoC",182,160,22,83,69,14,27,24,3,2011,24,20,4,13,11,2,NA,NA
"1831","NY","519","Columbia, Greene Counties CoC",177,177,0,97,97,0,29,29,0,2011,4,4,0,0,0,0,NA,NA
"1832","NY","520","Franklin, Essex Counties CoC",22,3,19,10,0,10,2,0,2,2011,6,1,5,0,0,0,NA,NA
"1833","NY","522","Jefferson, Lewis, St. Lawrence Counties CoC",108,107,1,43,43,0,13,13,0,2011,8,7,1,5,5,0,NA,NA
"1834","NY","523","Glens Falls, Saratoga Springs/Saratoga, Washington, Warren, Hamilton Counties Co",320,275,45,121,121,0,39,39,0,2011,27,18,9,25,21,4,NA,NA
"1835","NY","600","New York City CoC",51123,48475,2648,30139,30139,0,10045,10045,0,2011,2679,984,1695,4677,4227,450,NA,NA
"1836","NY","601","Poughkeepsie/Dutchess County CoC",435,421,14,222,222,0,89,89,0,2011,70,60,10,14,14,0,NA,NA
"1837","NY","602","Newburgh, Middletown/Orange County CoC",448,266,182,135,120,15,51,46,5,2011,148,47,101,19,9,10,NA,NA
"1838","NY","603","Nassau, Suffolk Counties CoC",3278,3166,112,2236,2236,0,686,686,0,2011,197,188,9,439,433,6,NA,NA
"1839","NY","604","Yonkers, Mount Vernon/Westchester County CoC",1537,1495,42,854,854,0,288,288,0,2011,282,240,42,161,152,9,NA,NA
"1840","NY","606","Rockland County CoC",112,80,32,45,45,0,16,16,0,2011,52,20,32,1,1,0,NA,NA
"1841","NY","607","Sullivan County CoC",525,423,102,286,184,102,97,62,35,2011,88,53,35,11,11,0,NA,NA
"1842","NY","608","Kingston/Ulster County CoC",259,206,53,105,98,7,35,32,3,2011,38,5,33,13,7,6,NA,NA
"1843","OH","500","Cincinnati/Hamilton County CoC",1275,1209,66,545,545,0,167,167,0,2011,223,200,23,192,186,6,NA,NA
"1844","OH","501","Toledo/Lucas County CoC",1096,859,237,314,269,45,108,96,12,2011,207,187,20,90,70,20,NA,NA
"1845","OH","502","Cleveland/Cuyahoga County CoC",2262,2066,196,496,491,5,173,171,2,2011,398,321,77,388,349,39,NA,NA
"1846","OH","503","Columbus/Franklin County CoC",1418,1274,144,395,395,0,127,127,0,2011,303,173,130,145,116,29,NA,NA
"1847","OH","504","Youngstown/Mahoning County CoC",223,209,14,99,99,0,32,32,0,2011,46,32,14,12,10,2,NA,NA
"1848","OH","505","Dayton, Kettering/Montgomery County CoC",986,948,38,384,384,0,122,122,0,2011,60,49,11,156,153,3,NA,NA
"1849","OH","506","Akron, Barberton/Summit County CoC",857,711,146,315,315,0,97,97,0,2011,210,122,88,76,25,51,NA,NA
"1850","OH","507","Ohio Balance of State CoC",4431,3534,897,2423,2157,266,777,692,85,2011,492,248,244,200,165,35,NA,NA
"1851","OH","508","Canton, Massillon, Alliance/Stark County CoC",482,414,68,247,240,7,80,78,2,2011,75,50,25,20,9,11,NA,NA
"1852","OK","500","North Central Oklahoma CoC",249,163,86,114,87,27,36,27,9,2011,44,16,28,9,3,6,NA,NA
"1853","OK","501","Tulsa City & County CoC",879,829,50,183,181,2,61,60,1,2011,97,90,7,165,160,5,NA,NA
"1854","OK","502","Oklahoma City CoC",1348,1019,329,236,200,36,80,65,15,2011,231,83,148,129,96,33,NA,NA
"1855","OK","503","Oklahoma Balance of State CoC",483,126,357,173,56,117,66,24,42,2011,159,35,124,0,0,0,NA,NA
"1856","OK","504","Norman/Cleveland County CoC",619,162,457,201,89,112,61,28,33,2011,66,43,23,6,6,0,NA,NA
"1857","OK","505","Northeast Oklahoma CoC",266,233,33,106,98,8,39,36,3,2011,91,77,14,13,11,2,NA,NA
"1858","OK","506","Southwest Oklahoma Regional CoC",133,123,10,58,56,2,27,26,1,2011,3,1,2,15,13,2,NA,NA
"1859","OK","507","Southeastern Oklahoma Regional CoC",648,333,315,318,151,167,99,45,54,2011,102,73,29,19,12,7,NA,NA
"1860","OR","500","Eugene, Springfield/Lane County CoC",2140,734,1406,607,374,233,190,121,69,2011,679,130,549,254,68,186,NA,NA
"1861","OR","501","Portland, Gresham/Multnomah County CoC",4497,2783,1714,1682,1570,112,537,482,55,2011,971,185,786,457,239,218,NA,NA
"1862","OR","502","Medford, Ashland/Jackson County CoC",1049,572,477,469,221,248,205,100,105,2011,757,313,444,180,163,17,NA,NA
"1863","OR","503","Central Oregon CoC",802,270,532,386,163,223,125,52,73,2011,155,38,117,77,15,62,NA,NA
"1864","OR","505","Oregon Balance of State CoC",7006,2293,4713,3907,1144,2763,1312,390,922,2011,831,228,603,369,135,234,NA,NA
"1865","OR","506","Hillsboro, Beaverton/Washington County CoC",752,221,531,317,168,149,102,55,47,2011,189,18,171,62,35,27,NA,NA
"1866","OR","507","Clackamas County CoC",1008,139,869,441,123,318,152,42,110,2011,157,4,153,75,0,75,NA,NA
"1867","PA","500","Philadelphia CoC",6180,5674,506,2852,2852,0,918,918,0,2011,735,343,392,353,286,67,NA,NA
"1868","PA","501","Harrisburg/Dauphin County CoC",394,321,73,176,169,7,69,66,3,2011,79,44,35,44,33,11,NA,NA
"1869","PA","502","Upper Darby, Chester, Haverford/Delaware County CoC",648,601,47,398,398,0,106,106,0,2011,55,25,30,29,26,3,NA,NA
"1870","PA","503","Wilkes-Barre, Hazleton/Luzerne County CoC",180,171,9,64,64,0,23,23,0,2011,13,8,5,25,23,2,NA,NA
"1871","PA","504","Lower Merion, Norristown, Abington/Montgomery County CoC",410,400,10,258,258,0,78,78,0,2011,43,34,9,10,10,0,NA,NA
"1872","PA","505","Chester County CoC",726,717,9,205,205,0,71,71,0,2011,51,51,0,293,293,0,NA,NA
"1873","PA","506","Reading/Berks County CoC",357,350,7,126,126,0,47,47,0,2011,8,4,4,18,17,1,NA,NA
"1874","PA","508","Scranton/Lackawanna County CoC",276,236,40,154,154,0,56,56,0,2011,58,53,5,35,35,0,NA,NA
"1875","PA","509","Eastern Pennsylvania CoC",1720,1589,131,1057,1044,13,358,355,3,2011,114,84,30,85,67,18,NA,NA
"1876","PA","510","Lancaster City & County CoC",505,498,7,255,255,0,89,89,0,2011,38,33,5,57,54,3,NA,NA
"1877","PA","511","Bristol, Bensalem/Bucks County CoC",505,472,33,325,325,0,118,118,0,2011,16,7,9,3,0,3,NA,NA
"1878","PA","512","York City & County CoC",257,232,25,105,98,7,35,32,3,2011,32,27,5,22,20,2,NA,NA
"1879","PA","600","Pittsburgh, McKeesport, Penn Hills/Allegheny County CoC",1423,1366,57,552,552,0,199,199,0,2011,209,180,29,225,215,10,NA,NA
"1880","PA","601","Western Pennsylvania CoC",991,925,66,472,443,29,158,148,10,2011,178,171,7,153,151,2,NA,NA
"1881","PA","603","Beaver County CoC",119,112,7,54,54,0,19,19,0,2011,16,9,7,4,4,0,NA,NA
"1882","PA","605","Erie City & County CoC",405,372,33,176,167,9,52,48,4,2011,74,66,8,36,28,8,NA,NA
"1883","RI","500","Rhode Island Statewide CoC",1070,1039,31,418,418,0,137,137,0,2011,176,171,5,123,121,2,NA,NA
"1884","SC","500","Charleston/Low Country CoC",569,357,212,72,68,4,27,26,1,2011,89,46,43,151,125,26,NA,NA
"1885","SC","501","Greenville, Anderson, Spartanburg/Upstate CoC",1401,1216,185,477,477,0,150,150,0,2011,57,56,1,115,91,24,NA,NA
"1886","SC","502","Columbia/Midlands CoC",1621,919,702,392,309,83,154,126,28,2011,238,95,143,264,149,115,NA,NA
"1887","SC","503","Myrtle Beach, Sumter City & County CoC",1502,462,1040,647,133,514,196,45,151,2011,261,34,227,82,24,58,NA,NA
"1888","SD","500","South Dakota Statewide CoC",826,762,64,366,349,17,123,119,4,2011,34,21,13,109,99,10,NA,NA
"1889","TN","500","Chattanooga/Southeast Tennessee CoC",561,334,227,186,106,80,62,32,30,2011,35,9,26,55,10,45,NA,NA
"1890","TN","501","Memphis/Shelby County CoC",1942,1758,184,707,705,2,210,209,1,2011,112,32,80,186,162,24,NA,NA
"1891","TN","502","Knoxville/Knox County CoC",998,849,149,158,147,11,61,57,4,2011,197,150,47,108,82,26,NA,NA
"1892","TN","503","Central Tennessee CoC",232,213,19,33,33,0,9,9,0,2011,31,27,4,33,30,3,NA,NA
"1893","TN","504","Nashville-Davidson County CoC",1938,1575,363,243,243,0,86,86,0,2011,860,500,360,372,264,108,NA,NA
"1894","TN","506","Upper Cumberland CoC",526,171,355,321,96,225,112,34,78,2011,46,21,25,7,6,1,NA,NA
"1895","TN","507","Jackson/West Tennessee CoC",1894,428,1466,660,82,578,273,29,244,2011,225,50,175,93,93,0,NA,NA
"1896","TN","509","Appalachian Regional CoC",360,259,101,160,131,29,50,44,6,2011,66,41,25,69,63,6,NA,NA
"1897","TN","510","Murfreesboro/Rutherford County CoC",225,127,98,65,65,0,18,18,0,2011,84,26,58,25,17,8,NA,NA
"1898","TN","512","Morristown/Blount, Sevier, Campbell, Cocke Counties CoC",437,201,236,105,69,36,29,21,8,2011,101,48,53,17,5,12,NA,NA
"1899","TX","500","San Antonio/Bexar County CoC",3222,2046,1176,883,879,4,387,385,2,2011,676,438,238,351,252,99,NA,NA
"1900","TX","503","Austin/Travis County CoC",2362,1358,1004,662,657,5,217,215,2,2011,793,327,466,515,293,222,NA,NA
"1901","TX","600","Dallas City & County, Irving CoC",3540,3297,243,1949,1915,34,651,642,9,2011,760,608,152,555,521,34,NA,NA
"1902","TX","601","Fort Worth, Arlington/Tarrant County CoC",2169,2033,136,922,920,2,292,291,1,2011,328,290,38,235,207,28,NA,NA
"1903","TX","603","El Paso City & County CoC",1331,1149,182,622,622,0,170,170,0,2011,100,60,40,134,87,47,NA,NA
"1904","TX","604","Waco/McLennan County CoC",267,206,61,95,90,5,37,36,1,2011,52,20,32,40,23,17,NA,NA
"1905","TX","607","Texas Balance of State CoC",14643,4054,10589,5728,1555,4173,1754,534,1220,2011,3319,987,2332,1840,515,1325,NA,NA
"1906","TX","611","Amarillo CoC",439,399,40,162,162,0,59,59,0,2011,65,36,29,47,39,8,NA,NA
"1907","TX","624","Wichita Falls/Wise, Palo Pinto, Wichita, Archer Counties CoC",234,208,26,41,41,0,12,12,0,2011,197,145,52,15,10,5,NA,NA
"1908","TX","700","Houston, Pasadena, Conroe/Harris, Ft. Bend, Montgomery, Counties CoC",8471,4053,4418,2178,1648,530,752,540,212,2011,1914,323,1591,1146,405,741,NA,NA
"1909","TX","701","Bryan, College Station/Brazos Valley CoC",233,169,64,92,76,16,26,22,4,2011,19,19,0,13,13,0,NA,NA
"1910","UT","500","Salt Lake City & County CoC",2033,1844,189,827,805,22,241,237,4,2011,264,222,42,264,245,19,NA,NA
"1911","UT","503","Utah Balance of State CoC",898,701,197,386,373,13,126,122,4,2011,99,62,37,69,60,9,NA,NA
"1912","UT","504","Provo/Mountainland CoC",199,142,57,75,75,0,22,22,0,2011,20,0,20,12,5,7,NA,NA
"1913","VA","500","Richmond/Henrico, Chesterfield, Hanover Counties CoC",1084,1039,45,247,247,0,85,85,0,2011,69,54,15,160,150,10,NA,NA
"1914","VA","501","Norfolk/Chesapeake, Suffolk, Isle of Wight, Southampton Counties CoC",609,550,59,190,183,7,61,59,2,2011,65,45,20,81,62,19,NA,NA
"1915","VA","502","Roanoke City & County, Salem CoC",536,526,10,124,124,0,44,44,0,2011,186,182,4,78,78,0,NA,NA
"1916","VA","503","Virginia Beach CoC",427,333,94,179,177,2,59,58,1,2011,81,43,38,56,40,16,NA,NA
"1917","VA","504","Charlottesville CoC",213,195,18,54,54,0,24,24,0,2011,60,42,18,13,10,3,NA,NA
"1918","VA","505","Newport News, Hampton/Virginia Peninsula CoC",736,634,102,225,216,9,68,65,3,2011,129,89,40,226,216,10,NA,NA
"1919","VA","507","Portsmouth CoC",265,165,100,66,66,0,21,21,0,2011,87,39,48,44,18,26,NA,NA
"1920","VA","508","Lynchburg CoC",226,187,39,97,78,19,28,22,6,2011,23,11,12,20,17,3,NA,NA
"1921","VA","513","Harrisburg, Winchester/Western Virginia CoC",311,284,27,117,106,11,42,40,2,2011,72,63,9,25,23,2,NA,NA
"1922","VA","514","Fredericksburg/Spotsylvania, Stafford Counties CoC",191,142,49,56,56,0,21,21,0,2011,67,40,27,17,14,3,NA,NA
"1923","VA","521","Virginia Balance of State CoC",1064,720,344,535,466,69,179,155,24,2011,137,51,86,50,30,20,NA,NA
"1924","VA","600","Arlington County CoC",461,324,137,193,193,0,65,65,0,2011,154,64,90,29,13,16,NA,NA
"1925","VA","601","Fairfax County CoC",1549,1414,135,883,883,0,265,265,0,2011,278,174,104,55,46,9,NA,NA
"1926","VA","602","Loudoun County CoC",162,133,29,76,76,0,24,24,0,2011,22,8,14,10,6,4,NA,NA
"1927","VA","603","Alexandria CoC",416,374,42,152,152,0,52,52,0,2011,109,74,35,27,24,3,NA,NA
"1928","VA","604","Prince William County CoC",566,366,200,391,292,99,107,84,23,2011,104,50,54,40,21,19,NA,NA
"1929","VT","500","Vermont Balance of State CoC",655,579,76,279,263,16,73,68,5,2011,66,53,13,63,61,2,NA,NA
"1930","VT","501","Burlington/Chittenden County CoC",489,442,47,228,225,3,83,82,1,2011,48,34,14,18,14,4,NA,NA
"1931","WA","500","Seattle/King County CoC",8972,6480,2492,3488,3438,50,1040,1023,17,2011,896,666,230,587,546,41,NA,NA
"1932","WA","501","Washington Balance of State CoC",5399,3661,1738,2745,2236,509,847,713,134,2011,858,325,533,462,322,140,NA,NA
"1933","WA","502","Spokane City & County CoC",1272,1134,138,630,612,18,274,268,6,2011,76,47,29,91,73,18,NA,NA
"1934","WA","503","Tacoma, Lakewood/Pierce County CoC",2089,1867,222,1243,1230,13,367,363,4,2011,232,87,145,158,125,33,NA,NA
"1935","WA","504","Everett/Snohomish County CoC",1860,1273,587,1030,958,72,354,333,21,2011,228,146,82,85,38,47,NA,NA
"1936","WA","508","Vancouver/Clark County CoC",847,660,187,435,383,52,158,140,18,2011,98,42,56,95,63,32,NA,NA
"1937","WI","500","Wisconsin Balance of State CoC",3400,3149,251,1968,1877,91,677,649,28,2011,217,196,21,310,303,7,NA,NA
"1938","WI","501","Milwaukee City & County CoC",1466,1331,135,574,569,5,184,183,1,2011,127,90,37,192,177,15,NA,NA
"1939","WI","502","Racine City & County CoC",243,242,1,99,99,0,31,31,0,2011,32,32,0,39,39,0,NA,NA
"1940","WI","503","Madison/Dane County CoC",676,633,43,306,306,0,102,102,0,2011,121,107,14,66,65,1,NA,NA
"1941","WV","500","Wheeling, Weirton Area CoC",124,107,17,34,34,0,16,16,0,2011,43,34,9,7,5,2,NA,NA
"1942","WV","501","Huntington/Cabell, Wayne Counties CoC",238,207,31,80,80,0,30,30,0,2011,28,13,15,21,12,9,NA,NA
"1943","WV","503","Charleston/Kanawha, Putnam, Boone, Clay Counties CoC",394,360,34,88,88,0,30,30,0,2011,56,36,20,33,33,0,NA,NA
"1944","WV","508","West Virginia Balance of State CoC",1455,731,724,347,211,136,131,80,51,2011,172,106,66,241,186,55,NA,NA
"1945","WY","500","Wyoming Statewide CoC",1038,195,843,718,68,650,223,29,194,2011,104,27,77,83,39,44,NA,NA
"1946",NA,NA,"Total",623788,392316,231472,236175,186482,49693,77184,61636,15548,2011,119033,46169,72864,65455,40033,25422,NA,NA
"1947","AK","500","Anchorage CoC",1147,1097,50,356,341,15,126,122,4,2012,114,109,5,174,167,7,NA,NA
"1948","AK","501","Alaska Balance of State CoC",766,619,147,259,218,41,90,72,18,2012,165,154,11,82,60,22,NA,NA
"1949","AL","500","Birmingham/Jefferson, St. Clair, Shelby Counties CoC",1707,1009,698,485,336,149,191,120,71,2012,495,140,355,175,117,58,NA,NA
"1950","AL","501","Mobile City & County/Baldwin County CoC",634,324,310,212,169,43,62,52,10,2012,75,17,58,52,12,40,NA,NA
"1951","AL","502","Florence/Northwest Alabama CoC",192,188,4,30,30,0,10,10,0,2012,3,3,0,7,7,0,NA,NA
"1952","AL","503","Huntsville/North Alabama CoC",607,432,175,159,122,37,57,44,13,2012,185,105,80,42,32,10,NA,NA
"1953","AL","504","Montgomery City & County CoC",487,343,144,104,95,9,33,30,3,2012,82,15,67,67,40,27,NA,NA
"1954","AL","505","Gadsden/Northeast Alabama CoC",544,424,120,93,42,51,30,15,15,2012,44,16,28,13,12,1,NA,NA
"1955","AL","506","Tuscaloosa City & County CoC",152,128,24,53,53,0,21,21,0,2012,39,31,8,114,114,0,NA,NA
"1956","AL","507","Alabama Balance of State CoC",886,816,70,248,244,4,93,91,2,2012,46,26,20,56,43,13,NA,NA
"1957","AR","500","Little Rock/Central Arkansas CoC",1249,762,487,184,184,0,42,42,0,2012,123,76,47,266,156,110,NA,NA
"1958","AR","501","Fayetteville/Northwest Arkansas CoC",186,147,39,77,69,8,31,28,3,2012,60,24,36,30,24,6,NA,NA
"1959","AR","503","Arkansas  Balance of State  CoC",1930,562,1368,142,101,41,58,41,17,2012,171,49,122,60,23,37,NA,NA
"1960","AR","504","Delta Hills CoC",785,67,718,362,36,326,130,18,112,2012,83,22,61,6,2,4,NA,NA
"1961","AR","505","Southeast Arkansas CoC",64,64,0,21,21,0,5,5,0,2012,0,0,0,0,0,0,NA,NA
"1962","AR","512","Boone, Baxter, Marion, Newton Counties CoC",NA,NA,NA,NA,NA,NA,NA,NA,NA,2012,NA,NA,NA,NA,NA,NA,NA,NA
"1963","AZ","500","Arizona Balance of State CoC",2451,1722,729,1070,637,433,334,232,102,2012,545,278,267,273,160,113,NA,NA
"1964","AZ","501","Tucson/Pima County CoC",2366,1757,609,858,736,122,256,223,33,2012,395,171,224,353,242,111,NA,NA
"1965","AZ","502","Phoenix, Mesa/Maricopa County CoC",6485,4736,1749,3064,3056,8,875,872,3,2012,955,166,789,852,605,247,NA,NA
"1966","CA","500","San Jose/Santa Clara City & County CoC",7053,1884,5169,783,727,56,262,244,18,2012,2657,327,2330,667,152,515,NA,NA
"1967","CA","501","San Francisco CoC",5895,2524,3371,718,623,95,268,228,40,2012,1899,789,1110,774,344,430,NA,NA
"1968","CA","502","Oakland, Berkeley/Alameda County CoC",4257,2045,2212,1049,909,140,332,308,24,2012,1092,108,984,440,95,345,NA,NA
"1969","CA","503","Sacramento City & County CoC",2812,1857,955,827,822,5,237,235,2,2012,463,221,242,329,148,181,NA,NA
"1970","CA","504","Santa Rosa, Petaluma/Sonoma County CoC",4483,1117,3366,593,553,40,186,174,12,2012,1032,77,955,384,57,327,NA,NA
"1971","CA","505","Richmond/Contra Costa County CoC",2386,896,1490,426,423,3,137,136,1,2012,753,220,533,82,74,8,NA,NA
"1972","CA","506","Salinas/Monterey, San Benito Counties CoC",2673,762,1911,912,758,154,153,122,31,2012,822,43,779,290,46,244,NA,NA
"1973","CA","507","Marin County CoC",725,496,229,209,209,0,80,80,0,2012,163,62,101,51,26,25,NA,NA
"1974","CA","508","Watsonville/Santa Cruz City & County CoC",2735,610,2125,390,330,60,123,108,15,2012,990,43,947,271,26,245,NA,NA
"1975","CA","509","Mendocino County CoC",1441,127,1314,94,34,60,32,12,20,2012,319,7,312,84,10,74,NA,NA
"1976","CA","510","Turlock, Modesto/Stanislaus County CoC",1470,679,791,609,417,192,188,139,49,2012,306,166,140,49,19,30,NA,NA
"1977","CA","511","Stockton/San Joaquin County CoC",1569,1322,247,830,805,25,254,247,7,2012,236,125,111,80,60,20,NA,NA
"1978","CA","512","Daly/San Mateo County CoC",1845,683,1162,571,438,133,160,123,37,2012,496,20,476,173,26,147,NA,NA
"1979","CA","513","Visalia/Kings, Tulare Counties CoC",771,416,355,205,170,35,62,52,10,2012,201,21,180,40,8,32,NA,NA
"1980","CA","514","Fresno City & County/Madera County CoC",4492,670,3822,938,340,598,366,113,253,2012,824,37,787,606,64,542,NA,NA
"1981","CA","515","Roseville, Rocklin/Placer, Nevada Counties CoC",742,387,355,234,196,38,75,62,13,2012,168,46,122,59,22,37,NA,NA
"1982","CA","516","Redding/Shasta, Siskiyou, Lassen, Plumas, Del Norte, Modoc, Sierra Counties CoC",524,342,182,140,110,30,49,34,15,2012,180,92,88,67,38,29,NA,NA
"1983","CA","517","Napa City & County CoC",248,156,92,64,55,9,26,22,4,2012,85,51,34,14,5,9,NA,NA
"1984","CA","518","Vallejo/Solano County CoC",622,387,235,239,190,49,93,72,21,2012,64,64,0,28,14,14,NA,NA
"1985","CA","519","Chico, Paradise/Butte County CoC",897,357,540,137,110,27,46,36,10,2012,268,31,237,102,32,70,NA,NA
"1986","CA","520","Merced City & County CoC",502,164,338,23,23,0,7,7,0,2012,315,109,206,52,8,44,NA,NA
"1987","CA","521","Davis, Woodland/Yolo County CoC",513,250,263,130,113,17,42,37,5,2012,198,31,167,45,9,36,NA,NA
"1988","CA","522","Humboldt County CoC",846,392,454,213,160,53,70,51,19,2012,256,103,153,141,62,79,NA,NA
"1989","CA","523","Colusa, Glenn, Trinity Counties CoC",303,164,139,118,86,32,38,27,11,2012,109,41,68,32,21,11,NA,NA
"1990","CA","524","Yuba City & County/Sutter County CoC",492,272,220,181,123,58,59,39,20,2012,0,0,0,23,20,3,NA,NA
"1991","CA","525","El Dorado County CoC",217,180,37,62,56,6,26,23,3,2012,55,48,7,10,9,1,NA,NA
"1992","CA","526","Amador, Calaveras, Mariposa, Tuolumne Counties CoC",379,110,269,175,67,108,53,18,35,2012,86,6,80,24,6,18,NA,NA
"1993","CA","528","Del Norte County CoC",437,16,421,132,16,116,38,8,30,2012,384,0,384,10,0,10,NA,NA
"1994","CA","600","Los Angeles City & County CoC",31553,13813,17740,6944,4980,1964,2245,1693,552,2012,7930,1373,6557,4521,1483,3038,NA,NA
"1995","CA","601","San Diego City and County CoC",10013,4371,5642,2258,1612,646,810,526,284,2012,2691,231,2460,1753,831,922,NA,NA
"1996","CA","602","Santa Ana, Anaheim/Orange County CoC",7010,2738,4272,1753,1731,22,540,533,7,2012,1690,101,1589,869,109,760,NA,NA
"1997","CA","603","Santa Maria/Santa Barbara County CoC",1546,678,868,228,185,43,78,64,14,2012,650,264,386,173,85,88,NA,NA
"1998","CA","604","Bakersfield/Kern County CoC",1352,519,833,206,162,44,73,56,17,2012,445,52,393,172,78,94,NA,NA
"1999","CA","606","Long Beach CoC",3170,967,2203,561,294,267,177,91,86,2012,1123,139,984,629,320,309,NA,NA
"2000","CA","607","Pasadena CoC",904,467,437,125,119,6,50,47,3,2012,260,41,219,52,5,47,NA,NA
"2001","CA","608","Riverside City & County CoC",6096,1006,5090,491,460,31,153,143,10,2012,2643,192,2451,912,98,814,NA,NA
"2002","CA","609","San Bernardino City & County CoC",2532,840,1692,751,425,326,194,105,89,2012,210,30,180,224,58,166,NA,NA
"2003","CA","611","Oxnard, San Buenaventura/Ventura County CoC",1926,683,1243,299,260,39,89,78,11,2012,496,84,412,134,26,108,NA,NA
"2004","CA","612","Glendale CoC",299,179,120,134,134,0,45,45,0,2012,116,28,88,14,4,10,NA,NA
"2005","CA","613","Imperial County CoC",239,136,103,81,81,0,26,26,0,2012,179,21,158,6,0,6,NA,NA
"2006","CA","614","San Luis Obispo County CoC",2129,228,1901,377,90,287,134,26,108,2012,502,14,488,225,14,211,NA,NA
"2007","CO","500","Colorado Balance of State CoC",9283,1015,8268,7668,720,6948,1918,181,1737,2012,729,31,698,572,77,495,NA,NA
"2008","CO","503","Metropolitan Denver CoC",6358,5394,964,3681,3380,301,1081,998,83,2012,957,655,302,710,601,109,NA,NA
"2009","CO","504","Colorado Springs/El Paso County CoC",1127,851,276,318,313,5,105,103,2,2012,257,98,159,230,122,108,NA,NA
"2010","CT","503","Bridgeport, Stamford, Norwalk/Fairfield County CoC",902,741,161,315,303,12,107,102,5,2012,199,126,73,80,66,14,NA,NA
"2011","CT","505","Connecticut Balance of State CoC",3307,2773,534,988,959,29,342,330,12,2012,745,488,257,252,219,33,NA,NA
"2012","DE","500","Delaware Statewide CoC",1008,986,22,397,397,0,128,128,0,2012,100,89,11,66,64,2,NA,NA
"2013","FL","500","Sarasota, Bradenton/Manatee, Sarasota Counties CoC",921,664,257,188,165,23,67,59,8,2012,151,1,150,96,55,41,NA,NA
"2014","FL","501","Tampa/Hillsborough County CoC",7419,972,6447,2904,348,2556,832,122,710,2012,740,109,631,800,105,695,NA,NA
"2015","FL","502","St. Petersburg, Clearwater, Largo/Pinellas County CoC",3971,1951,2020,1049,249,800,279,80,199,2012,437,134,303,468,350,118,NA,NA
"2016","FL","503","Lakeland, Winterhaven/Polk County CoC",881,297,584,131,97,34,41,32,9,2012,83,16,67,57,21,36,NA,NA
"2017","FL","504","Daytona Beach, Daytona/Volusia, Flagler Counties CoC",2384,503,1881,261,261,0,80,80,0,2012,289,1,288,83,33,50,NA,NA
"2018","FL","505","Fort Walton Beach/Okaloosa, Walton Counties CoC",2438,510,1928,1463,148,1315,562,54,508,2012,492,233,259,318,166,152,NA,NA
"2019","FL","506","Tallahassee/Leon County CoC",797,738,59,163,163,0,58,58,0,2012,175,157,18,121,118,3,NA,NA
"2020","FL","507","Orlando/Orange, Osceola, Seminole Counties CoC",3661,2218,1443,1331,1013,318,446,324,122,2012,1030,274,756,574,229,345,NA,NA
"2021","FL","508","Gainesville/Alachua, Putnam Counties CoC",1814,389,1425,338,192,146,85,43,42,2012,692,210,482,263,133,130,NA,NA
"2022","FL","509","Fort Pierce/St. Lucie, Indian River, Martin Counties CoC",1724,179,1545,807,153,654,272,55,217,2012,182,10,172,74,8,66,NA,NA
"2023","FL","510","Jacksonville-Duval, Clay Counties CoC",2861,1542,1319,567,526,41,202,185,17,2012,439,132,307,292,141,151,NA,NA
"2024","FL","511","Pensacola/Escambia, Santa Rosa Counties CoC",792,526,266,125,118,7,42,39,3,2012,232,31,201,104,62,42,NA,NA
"2025","FL","512","St. Johns County CoC",1385,184,1201,389,128,261,107,49,58,2012,79,4,75,43,8,35,NA,NA
"2026","FL","513","Palm Bay, Melbourne/Brevard County CoC",2062,743,1319,676,453,223,317,220,97,2012,138,73,65,352,123,229,NA,NA
"2027","FL","514","Ocala/Marion County CoC",911,311,600,124,118,6,48,45,3,2012,88,3,85,136,15,121,NA,NA
"2028","FL","515","Panama City/Bay, Jackson Counties CoC",322,235,87,78,75,3,28,27,1,2012,56,38,18,53,33,20,NA,NA
"2029","FL","517","Hendry, Hardee, Highlands Counties CoC",1319,114,1205,760,0,760,376,0,376,2012,412,0,412,10,0,10,NA,NA
"2030","FL","518","Columbia, Hamilton, Lafayette, Suwannee Counties CoC",1180,84,1096,377,21,356,149,7,142,2012,255,26,229,241,24,217,NA,NA
"2031","FL","519","Pasco County CoC",4351,192,4159,3043,51,2992,1222,25,1197,2012,1540,82,1458,98,23,75,NA,NA
"2032","FL","520","Citrus, Hernando, Lake, Sumter Counties CoC",1788,403,1385,561,165,396,223,60,163,2012,26,13,13,31,26,5,NA,NA
"2033","FL","600","Miami-Dade County CoC",3976,3108,868,1459,1459,0,427,427,0,2012,601,227,374,265,163,102,NA,NA
"2034","FL","601","Ft Lauderdale/Broward County CoC",3183,1915,1268,556,525,31,172,160,12,2012,760,344,416,370,149,221,NA,NA
"2035","FL","602","Punta Gorda/Charlotte County CoC",756,211,545,172,33,139,39,7,32,2012,204,27,177,97,26,71,NA,NA
"2036","FL","603","Ft Myers, Cape Coral/Lee County CoC",781,410,371,144,68,76,40,24,16,2012,182,72,110,82,46,36,NA,NA
"2037","FL","604","Monroe County CoC",922,364,558,129,63,66,47,22,25,2012,274,70,204,92,52,40,NA,NA
"2038","FL","605","West Palm Beach/Palm Beach County CoC",2116,719,1397,449,284,165,129,91,38,2012,456,91,365,186,76,110,NA,NA
"2039","FL","606","Naples/Collier County CoC",455,350,105,155,155,0,43,43,0,2012,41,28,13,25,16,9,NA,NA
"2040","GA","500","Atlanta CoC",6811,4433,2378,1353,1311,42,576,561,15,2012,1709,1082,627,1232,798,434,NA,NA
"2041","GA","501","Georgia Balance of State CoC",11105,2250,8855,3233,1656,1577,1016,517,499,2012,1795,179,1616,850,141,709,NA,NA
"2042","GA","503","Athens-Clarke County CoC",361,138,223,88,80,8,28,25,3,2012,71,21,50,29,9,20,NA,NA
"2043","GA","504","Augusta-Richmond County CoC",396,391,5,131,128,3,44,43,1,2012,94,92,2,63,63,0,NA,NA
"2044","GA","505","Columbus-Muscogee/Russell County CoC",333,278,55,97,81,16,29,24,5,2012,29,21,8,34,29,5,NA,NA
"2045","GA","506","Marietta/Cobb County CoC",392,343,49,199,196,3,68,67,1,2012,40,10,30,35,15,20,NA,NA
"2046","GA","507","Savannah/Chatham County CoC",1118,487,631,52,52,0,18,18,0,2012,105,21,84,54,39,15,NA,NA
"2047","HI","500","Hawaii Balance of State CoC",1893,691,1202,772,481,291,217,147,70,2012,345,37,308,140,28,112,NA,NA
"2048","HI","501","Honolulu City and County CoC",4353,3035,1318,2344,2170,174,575,534,41,2012,604,109,495,367,202,165,NA,NA
"2049","IA","500","Sioux City/Dakota, Woodbury Counties CoC",250,233,17,131,131,0,47,47,0,2012,46,44,2,10,8,2,NA,NA
"2050","IA","501","Iowa Balance of State CoC",1860,1803,57,1042,1038,4,328,327,1,2012,155,124,31,106,101,5,NA,NA
"2051","IA","502","Des Moines/Polk County CoC",818,744,74,309,309,0,91,91,0,2012,106,50,56,101,96,5,NA,NA
"2052","ID","500","Boise/Ada County CoC",754,701,53,188,186,2,54,53,1,2012,86,71,15,139,125,14,NA,NA
"2053","ID","501","Idaho Balance of State CoC",1214,781,433,605,509,96,192,163,29,2012,166,40,126,121,59,62,NA,NA
"2054","IL","500","McHenry County CoC",196,193,3,73,73,0,23,23,0,2012,43,43,0,57,57,0,NA,NA
"2055","IL","501","Rockford/Winnebago, Boone Counties CoC",727,525,202,285,184,101,105,69,36,2012,152,117,35,88,71,17,NA,NA
"2056","IL","502","Waukegan, North Chicago/Lake County CoC",450,445,5,191,191,0,74,74,0,2012,66,66,0,62,62,0,NA,NA
"2057","IL","503","Champaign, Urbana, Rantoul/Champaign County CoC",209,183,26,75,66,9,26,22,4,2012,25,2,23,25,25,0,NA,NA
"2058","IL","504","Madison County CoC",196,182,14,152,152,0,49,49,0,2012,11,6,5,4,2,2,NA,NA
"2059","IL","506","Joliet, Bolingbrook/Will County CoC",291,282,9,127,127,0,42,42,0,2012,15,7,8,24,24,0,NA,NA
"2060","IL","507","Peoria, Pekin/Fulton, Tazewell, Peoria, Woodford Counties CoC",376,367,9,156,153,3,48,47,1,2012,48,47,1,22,21,1,NA,NA
"2061","IL","508","East St. Louis, Belleville/St. Clair County CoC",451,166,285,258,118,140,73,42,31,2012,70,4,66,67,46,21,NA,NA
"2062","IL","509","Dekalb City & County CoC",125,112,13,74,74,0,22,22,0,2012,2,0,2,2,2,0,NA,NA
"2063","IL","510","Chicago CoC",6710,4988,1722,2440,2379,61,770,740,30,2012,1118,395,723,520,270,250,NA,NA
"2064","IL","511","Cook County CoC",1242,1009,233,504,497,7,171,169,2,2012,192,80,112,115,88,27,NA,NA
"2065","IL","512","Bloomington/Central Illinois CoC",668,452,216,307,180,127,89,50,39,2012,60,49,11,25,25,0,NA,NA
"2066","IL","513","Springfield/Sangamon County CoC",251,242,9,91,91,0,27,27,0,2012,97,92,5,18,17,1,NA,NA
"2067","IL","514","DuPage County CoC",641,608,33,355,352,3,115,114,1,2012,113,98,15,31,30,1,NA,NA
"2068","IL","515","South Central Illinois CoC",124,124,0,91,91,0,29,29,0,2012,12,12,0,0,0,0,NA,NA
"2069","IL","516","Decatur/Macon County CoC",210,158,52,88,82,6,31,29,2,2012,49,29,20,9,6,3,NA,NA
"2070","IL","517","Aurora, Elgin/Kane County CoC",431,388,43,118,111,7,40,37,3,2012,74,65,9,34,30,4,NA,NA
"2071","IL","518","Rock Island, Moline/Northwestern Illinois CoC",263,235,28,134,120,14,43,39,4,2012,12,12,0,10,10,0,NA,NA
"2072","IL","519","West Central Illinois CoC",172,149,23,103,86,17,35,30,5,2012,17,11,6,3,1,2,NA,NA
"2073","IL","520","Southern Illinois CoC",411,341,70,253,214,39,93,82,11,2012,30,9,21,31,26,5,NA,NA
"2074","IN","502","Indiana Balance of State CoC",4612,3896,716,2435,2206,229,801,711,90,2012,251,124,127,342,223,119,NA,NA
"2075","IN","503","Indianapolis CoC",1647,1474,173,508,503,5,154,153,1,2012,294,245,49,345,324,21,NA,NA
"2076","KS","502","Wichita/Sedgwick County CoC",550,475,75,182,179,3,55,54,1,2012,138,106,32,53,41,12,NA,NA
"2077","KS","503","Topeka/Shawnee County CoC",577,527,50,172,167,5,43,41,2,2012,56,44,12,93,82,11,NA,NA
"2078","KS","505","Overland Park, Shawnee/Johnson County CoC",288,220,68,240,195,45,61,50,11,2012,13,12,1,3,1,2,NA,NA
"2079","KS","507","Kansas Balance of State CoC",1043,982,61,482,472,10,164,160,4,2012,115,100,15,184,172,12,NA,NA
"2080","KY","500","Kentucky Balance of State CoC",2328,1627,701,988,815,173,320,269,51,2012,233,105,128,170,127,43,NA,NA
"2081","KY","501","Louisville-Jefferson County CoC",1532,1380,152,498,489,9,163,161,2,2012,187,128,59,223,198,25,NA,NA
"2082","KY","502","Lexington-Fayette County CoC",1370,1312,58,462,460,2,184,183,1,2012,209,190,19,47,44,3,NA,NA
"2083","LA","500","Lafayette/Acadiana CoC",518,439,79,193,193,0,63,63,0,2012,76,39,37,61,49,12,NA,NA
"2084","LA","502","Shreveport, Bossier/Northwest Louisiana CoC",804,626,178,327,327,0,102,102,0,2012,123,37,86,129,92,37,NA,NA
"2085","LA","503","New Orleans/Jefferson Parish CoC",4903,1464,3439,578,533,45,191,173,18,2012,2422,147,2275,570,188,382,NA,NA
"2086","LA","505","Monroe/Northeast Louisiana CoC",257,198,59,138,132,6,48,46,2,2012,64,35,29,16,7,9,NA,NA
"2087","LA","506","Slidell/Southeast Louisiana CoC",276,237,39,123,113,10,35,33,2,2012,22,19,3,46,43,3,NA,NA
"2088","LA","507","Alexandria/Central Louisiana CoC",188,173,15,32,32,0,9,9,0,2012,12,4,8,33,31,2,NA,NA
"2089","LA","509","Louisiana Balance of State CoC",826,670,156,59,39,20,26,17,9,2012,174,71,103,44,40,4,NA,NA
"2090","MA","500","Boston CoC",5607,5426,181,3177,3177,0,1037,1037,0,2012,670,587,83,355,335,20,NA,NA
"2091","MA","502","Lynn CoC",414,400,14,308,308,0,123,123,0,2012,186,175,11,4,3,1,NA,NA
"2092","MA","503","Cape Cod Islands CoC",364,316,48,143,138,5,57,55,2,2012,68,39,29,29,20,9,NA,NA
"2093","MA","504","Springfield/Hampden County CoC",2444,2409,35,2062,2062,0,693,693,0,2012,155,135,20,34,33,1,NA,NA
"2094","MA","505","New Bedford CoC",374,354,20,116,116,0,43,43,0,2012,20,10,10,54,53,1,NA,NA
"2095","MA","506","Worcester City & County CoC",1572,1499,73,1021,1018,3,333,332,1,2012,35,35,0,123,119,4,NA,NA
"2096","MA","507","Pittsfield/Berkshire, Franklin, Hampshire Counties CoC",717,658,59,233,233,0,88,88,0,2012,155,125,30,247,244,3,NA,NA
"2097","MA","508","Lowell CoC",534,506,28,345,345,0,117,117,0,2012,77,68,9,30,30,0,NA,NA
"2098","MA","509","Cambridge CoC",485,413,72,128,128,0,46,46,0,2012,191,132,59,62,55,7,NA,NA
"2099","MA","510","Gloucester, Haverhill, Salem/Essex County CoC",993,955,38,727,727,0,295,295,0,2012,145,115,30,70,68,2,NA,NA
"2100","MA","511","Quincy, Brockton, Weymouth, Plymouth City and County CoC",1424,1364,60,1017,1017,0,346,346,0,2012,134,113,21,92,90,2,NA,NA
"2101","MA","515","Fall River CoC",307,285,22,186,186,0,57,57,0,2012,25,19,6,5,2,3,NA,NA
"2102","MA","516","Massachusetts Balance of State CoC",1872,1835,37,1518,1516,2,572,571,1,2012,146,133,13,66,64,2,NA,NA
"2103","MA","517","Somerville CoC",145,136,9,55,55,0,24,24,0,2012,41,37,4,9,9,0,NA,NA
"2104","MA","519","Attleboro, Taunton/Bristol County CoC",249,223,26,176,176,0,56,56,0,2012,7,0,7,1,1,0,NA,NA
"2105","MD","500","Cumberland/Allegany County CoC",110,96,14,21,21,0,8,8,0,2012,22,8,14,6,6,0,NA,NA
"2106","MD","501","Baltimore CoC",3854,2059,1795,928,515,413,320,163,157,2012,308,0,308,274,248,26,NA,NA
"2107","MD","502","Harford County CoC",189,177,12,111,111,0,36,36,0,2012,30,25,5,10,5,5,NA,NA
"2108","MD","503","Annapolis/Anne Arundel County CoC",373,311,62,160,160,0,48,48,0,2012,41,31,10,25,25,0,NA,NA
"2109","MD","504","Howard County CoC",230,148,82,116,107,9,36,33,3,2012,54,6,48,9,2,7,NA,NA
"2110","MD","505","Baltimore County CoC",800,522,278,385,302,83,134,106,28,2012,244,133,111,73,39,34,NA,NA
"2111","MD","506","Carroll County CoC",167,131,36,54,54,0,20,20,0,2012,20,11,9,8,8,0,NA,NA
"2112","MD","507","Cecil County CoC",187,171,16,36,36,0,13,13,0,2012,41,32,9,89,88,1,NA,NA
"2113","MD","508","Charles, Calvert, St.Mary's Counties CoC",1156,351,805,871,159,712,346,51,295,2012,198,80,118,23,17,6,NA,NA
"2114","MD","509","Frederick City & County CoC",285,213,72,116,114,2,39,38,1,2012,95,38,57,7,3,4,NA,NA
"2115","MD","510","Garrett County CoC",18,16,2,9,9,0,3,3,0,2012,0,0,0,0,0,0,NA,NA
"2116","MD","511","Mid-Shore Regional CoC",80,73,7,31,31,0,11,11,0,2012,6,3,3,1,1,0,NA,NA
"2117","MD","512","Hagerstown/Washington County CoC",161,126,35,73,62,11,25,21,4,2012,20,16,4,9,6,3,NA,NA
"2118","MD","513","Wicomico, Somerset, Worcester Counties CoC",221,221,0,73,73,0,22,22,0,2012,27,27,0,22,22,0,NA,NA
"2119","MD","600","Prince George's County CoC",641,475,166,362,362,0,113,113,0,2012,102,11,91,24,13,11,NA,NA
"2120","MD","601","Montgomery County CoC",982,852,130,381,381,0,126,126,0,2012,199,138,61,37,30,7,NA,NA
"2121","ME","500","Maine Statewide CoC",2393,2360,33,1106,1106,0,376,376,0,2012,233,231,2,116,116,0,NA,NA
"2122","MI","500","Michigan Balance of State CoC",2255,1836,419,1423,1287,136,471,428,43,2012,106,74,32,79,56,23,NA,NA
"2123","MI","501","Detroit CoC",3115,2762,353,550,550,0,185,185,0,2012,378,271,107,518,485,33,NA,NA
"2124","MI","502","Dearborn, Dearborn Heights, Westland/Wayne County CoC",476,457,19,297,293,4,85,83,2,2012,14,10,4,23,22,1,NA,NA
"2125","MI","503","St. Clair Shores, Warren/Macomb County CoC",607,301,306,116,92,24,52,40,12,2012,128,54,74,21,13,8,NA,NA
"2126","MI","504","Pontiac, Royal Oak/Oakland County CoC",743,506,237,152,144,8,58,55,3,2012,41,36,5,3,3,0,NA,NA
"2127","MI","505","Flint/Genesee County CoC",435,289,146,166,151,15,55,49,6,2012,69,26,43,29,12,17,NA,NA
"2128","MI","506","Grand Rapids, Wyoming/Kent County CoC",712,682,30,461,461,0,147,147,0,2012,91,61,30,13,13,0,NA,NA
"2129","MI","507","Portage, Kalamazoo City & County CoC",729,708,21,464,464,0,154,154,0,2012,53,43,10,30,27,3,NA,NA
"2130","MI","508","Lansing, East Lansing/Ingham County CoC",470,400,70,136,124,12,37,32,5,2012,90,74,16,78,72,6,NA,NA
"2131","MI","509","Washtenaw County CoC",381,338,43,165,165,0,69,69,0,2012,81,44,37,29,14,15,NA,NA
"2132","MI","510","Saginaw City & County CoC",402,325,77,159,159,0,49,49,0,2012,26,12,14,56,48,8,NA,NA
"2133","MI","511","Lenawee County CoC",118,96,22,74,58,16,22,18,4,2012,7,2,5,2,0,2,NA,NA
"2134","MI","512","Grand Traverse, Antrim, Leelanau Counties CoC",316,268,48,142,142,0,52,52,0,2012,89,61,28,24,17,7,NA,NA
"2135","MI","513","Marquette, Alger Counties CoC",80,76,4,19,19,0,4,4,0,2012,6,4,2,9,8,1,NA,NA
"2136","MI","514","Battle Creek/Calhoun County CoC",216,160,56,49,47,2,18,17,1,2012,26,8,18,38,12,26,NA,NA
"2137","MI","515","Monroe City & County CoC",113,109,4,32,32,0,7,7,0,2012,21,17,4,9,9,0,NA,NA
"2138","MI","516","Norton Shores, Muskegon City & County CoC",457,225,232,157,68,89,53,25,28,2012,56,11,45,13,5,8,NA,NA
"2139","MI","517","Jackson City & County CoC",256,200,56,149,149,0,46,46,0,2012,40,11,29,23,3,20,NA,NA
"2140","MI","518","Livingston County CoC",150,79,71,82,57,25,25,16,9,2012,19,4,15,2,1,1,NA,NA
"2141","MI","519","Holland/Ottawa County CoC",322,319,3,198,198,0,59,59,0,2012,20,20,0,15,15,0,NA,NA
"2142","MI","523","Eaton County CoC",239,134,105,204,123,81,55,30,25,2012,9,0,9,3,0,3,NA,NA
"2143","MN","500","Minneapolis/Hennepin County CoC",3285,3141,144,1805,1799,6,513,512,1,2012,740,686,54,126,116,10,NA,NA
"2144","MN","501","Saint Paul/Ramsey County CoC",1218,1107,111,557,553,4,197,195,2,2012,383,307,76,64,54,10,NA,NA
"2145","MN","502","Rochester/Southeast Minnesota CoC",379,359,20,228,228,0,78,78,0,2012,68,59,9,16,14,2,NA,NA
"2146","MN","503","Dakota, Anoka, Washington, Scott, Carver Counties",853,667,186,549,495,54,188,171,17,2012,196,95,101,14,10,4,NA,NA
"2147","MN","504","Northeast Minnesota CoC",178,80,98,117,56,61,33,15,18,2012,22,5,17,13,7,6,NA,NA
"2148","MN","505","St. Cloud/Central Minnesota CoC",547,407,140,231,195,36,72,62,10,2012,169,131,38,43,26,17,NA,NA
"2149","MN","506","Northwest Minnesota CoC",301,250,51,193,168,25,56,50,6,2012,40,20,20,5,1,4,NA,NA
"2150","MN","508","Moorhead/West Central Minnesota CoC",254,224,30,125,111,14,38,34,4,2012,27,19,8,13,10,3,NA,NA
"2151","MN","509","Duluth/St.Louis County CoC",568,386,182,284,260,24,97,89,8,2012,64,21,43,10,1,9,NA,NA
"2152","MN","511","Southwest Minnesota CoC",161,133,28,115,96,19,39,34,5,2012,9,3,6,5,4,1,NA,NA
"2153","MO","500","St. Louis County CoC",543,438,105,367,322,45,117,101,16,2012,43,36,7,36,34,2,NA,NA
"2154","MO","501","St.Louis City CoC",1506,1381,125,579,576,3,184,183,1,2012,136,97,39,214,196,18,NA,NA
"2155","MO","503","St. Charles City & County, Lincoln, Warren Counties CoC",1023,544,479,772,444,328,221,144,77,2012,92,31,61,5,4,1,NA,NA
"2156","MO","600","Springfield/Greene, Christian, Webster Counties CoC",662,494,168,254,236,18,81,75,6,2012,85,31,54,38,17,21,NA,NA
"2157","MO","602","Joplin/Jasper, Newton Counties CoC",1724,1666,58,1282,1282,0,408,408,0,2012,61,61,0,84,84,0,NA,NA
"2158","MO","603","St. Joseph/Andrew, Buchanan, DeKalb Counties CoC",186,171,15,67,67,0,21,21,0,2012,58,52,6,33,31,2,NA,NA
"2159","MO","604a","Kansas City, Independence, Lee’s Summit/Jackson, Wyandotte Counties, MO & KS",2705,1876,829,1252,884,368,469,354,115,2012,943,548,395,338,219,119,NA,NA
"2160","MO","606","Missouri Balance of State CoC",2114,1469,645,891,623,268,267,195,72,2012,263,185,78,191,162,29,NA,NA
"2161","MS","500","Jackson/Rankin, Madison Counties CoC",1037,380,657,154,150,4,77,75,2,2012,304,44,260,140,13,127,NA,NA
"2162","MS","501","Mississippi Balance of State CoC",1018,579,439,372,228,144,113,69,44,2012,119,13,106,59,39,20,NA,NA
"2163","MS","503","Gulf Port/Gulf Coast Regional CoC",358,83,275,93,38,55,31,14,17,2012,78,10,68,45,19,26,NA,NA
"2164","MT","500","Montana Statewide CoC",1833,1153,680,667,500,167,192,169,23,2012,388,213,175,323,147,176,NA,NA
"2165","NC","500","Winston-Salem/Forsyth County CoC",556,436,120,134,132,2,51,50,1,2012,183,112,71,43,27,16,NA,NA
"2166","NC","501","Asheville/Buncombe County CoC",560,478,82,94,94,0,18,18,0,2012,80,40,40,230,219,11,NA,NA
"2167","NC","502","Durham City & County CoC",698,635,63,126,126,0,43,43,0,2012,134,81,53,116,100,16,NA,NA
"2168","NC","503","North Carolina Balance of State CoC",2922,2266,656,1199,994,205,410,332,78,2012,256,138,118,143,102,41,NA,NA
"2169","NC","504","Greensboro, High Point CoC",990,835,155,310,310,0,100,100,0,2012,116,57,59,104,87,17,NA,NA
"2170","NC","505","Charlotte/Mecklenberg CoC",2567,2266,301,1041,1041,0,321,321,0,2012,202,127,75,373,360,13,NA,NA
"2171","NC","506","Wilmington/Brunswick, New Hanover, Pender Counties CoC",469,316,153,122,102,20,50,44,6,2012,44,14,30,28,21,7,NA,NA
"2172","NC","507","Raleigh/Wake County CoC",1116,928,188,273,269,4,94,92,2,2012,100,48,52,141,113,28,NA,NA
"2173","NC","509","Gastonia/Cleveland, Gaston, Lincoln Counties CoC",611,129,482,37,17,20,14,6,8,2012,80,40,40,47,12,35,NA,NA
"2174","NC","511","Fayetteville/Cumberland County CoC",1606,306,1300,717,174,543,233,49,184,2012,339,15,324,152,39,113,NA,NA
"2175","NC","513","Chapel Hill/Orange County CoC",110,82,28,22,22,0,7,7,0,2012,29,14,15,8,6,2,NA,NA
"2176","NC","516","Northwest North Carolina CoC",1319,132,1187,969,67,902,292,22,270,2012,58,16,42,28,5,23,NA,NA
"2177","ND","500","North Dakota Statewide CoC",688,635,53,203,190,13,70,64,6,2012,86,78,8,160,144,16,NA,NA
"2178","NE","500","Nebraska Balance of State CoC",1278,593,685,812,334,478,263,112,151,2012,136,34,102,28,13,15,NA,NA
"2179","NE","501","Omaha, Council Bluffs CoC",1530,1508,22,445,445,0,151,151,0,2012,204,199,5,143,141,2,NA,NA
"2180","NE","502","Lincoln CoC",981,856,125,317,317,0,100,100,0,2012,161,100,61,78,59,19,NA,NA
"2181","NH","500","New Hampshire Balance of State CoC",761,695,66,360,352,8,124,121,3,2012,132,84,48,43,38,5,NA,NA
"2182","NH","501","Manchester CoC",399,339,60,173,170,3,66,65,1,2012,57,43,14,16,14,2,NA,NA
"2183","NH","502","Nashua/Hillsborough County CoC",336,295,41,131,124,7,50,47,3,2012,85,53,32,68,64,4,NA,NA
"2184","NJ","500","Atlantic City & County CoC",631,562,69,172,170,2,58,57,1,2012,117,101,16,53,44,9,NA,NA
"2185","NJ","501","Bergen County CoC",454,422,32,170,164,6,65,62,3,2012,54,45,9,18,17,1,NA,NA
"2186","NJ","502","Burlington County CoC",823,794,29,416,412,4,141,139,2,2012,75,68,7,19,15,4,NA,NA
"2187","NJ","503","Camden City & County/Gloucester, Cape May, Cumberland Counties CoC",1215,1051,164,543,495,48,191,175,16,2012,95,65,30,97,82,15,NA,NA
"2188","NJ","504","Newark/Essex County CoC",1504,1335,169,563,539,24,201,195,6,2012,178,132,46,80,59,21,NA,NA
"2189","NJ","506","Jersey City, Bayonne/Hudson County CoC",2087,1793,294,1337,1309,28,520,509,11,2012,111,30,81,45,21,24,NA,NA
"2190","NJ","507","New Brunswick/Middlesex County CoC",1145,833,312,620,496,124,217,177,40,2012,63,33,30,35,16,19,NA,NA
"2191","NJ","508","Monmouth County CoC",650,595,55,378,353,25,131,125,6,2012,73,59,14,16,12,4,NA,NA
"2192","NJ","509","Morris County CoC",281,209,72,102,99,3,39,38,1,2012,37,22,15,14,11,3,NA,NA
"2193","NJ","510","Lakewood Township/Ocean County CoC",649,598,51,200,192,8,68,65,3,2012,38,36,2,6,3,3,NA,NA
"2194","NJ","511","Paterson/Passaic County CoC",518,418,100,262,226,36,71,63,8,2012,39,28,11,18,12,6,NA,NA
"2195","NJ","512","Salem County CoC",78,49,29,51,35,16,20,14,6,2012,1,0,1,2,0,2,NA,NA
"2196","NJ","513","Somerset County CoC",295,272,23,118,105,13,41,37,4,2012,2,0,2,97,93,4,NA,NA
"2197","NJ","514","Trenton/Mercer County CoC",1009,903,106,458,427,31,155,144,11,2012,71,48,23,71,61,10,NA,NA
"2198","NJ","515","Elizabeth/Union County CoC",1456,1406,50,944,940,4,296,294,2,2012,27,20,7,16,16,0,NA,NA
"2199","NJ","516","Warren, Sussex, Hunterdon Counties CoC",230,189,41,88,80,8,33,29,4,2012,45,30,15,5,3,2,NA,NA
"2200","NM","500","Albuquerque CoC",1431,1044,387,427,389,38,142,133,9,2012,428,267,161,187,116,71,NA,NA
"2201","NM","501","New Mexico Balance of State CoC",1814,1353,461,682,537,145,206,156,50,2012,644,346,298,158,86,72,NA,NA
"2202","NV","500","Las Vegas/Clark County CoC",7323,3082,4241,742,724,18,251,245,6,2012,1449,374,1075,1113,595,518,NA,NA
"2203","NV","501","Reno, Sparks/Washoe County CoC",869,705,164,120,120,0,38,38,0,2012,215,208,7,112,92,20,NA,NA
"2204","NV","502","Nevada Balance of State CoC",305,183,122,142,127,15,52,45,7,2012,61,17,44,4,4,0,NA,NA
"2205","NY","500","Rochester, Irondequoit, Greece/Monroe County CoC",699,699,0,322,322,0,115,115,0,2012,89,89,0,53,53,0,NA,NA
"2206","NY","501","Elmira/Steuben, Allegany, Livingston, Chemung, Schuyler Counties CoC",305,286,19,85,83,2,25,24,1,2012,38,26,12,23,10,13,NA,NA
"2207","NY","503","Albany City & County CoC",590,562,28,218,218,0,98,98,0,2012,108,80,28,112,107,5,NA,NA
"2208","NY","504","Cattaragus County CoC",38,37,1,27,27,0,8,8,0,2012,6,5,1,3,3,0,NA,NA
"2209","NY","505","Syracuse, Auburn/Onondaga, Oswego, Cayuga Counties CoC",882,866,16,229,229,0,85,85,0,2012,119,105,14,69,69,0,NA,NA
"2210","NY","506","Fulton, Montgomery, Schoharie Counties CoC",72,64,8,37,37,0,10,10,0,2012,3,2,1,0,0,0,NA,NA
"2211","NY","507","Schenectady City & County CoC",287,269,18,97,97,0,43,43,0,2012,59,50,9,14,12,2,NA,NA
"2212","NY","508","Buffalo, Niagara Falls/Erie, Niagara, Orleans, Genesee, Wyoming Counties CoC",1183,1067,116,413,413,0,136,136,0,2012,133,87,46,67,63,4,NA,NA
"2213","NY","510","Ithaca/Tompkins County CoC",68,53,15,29,29,0,11,11,0,2012,13,2,11,1,0,1,NA,NA
"2214","NY","511","Binghamton, Union Town/Broome, Otsego, Chenango, Delaware, Cortland, Tioga Count",292,281,11,9,9,0,3,3,0,2012,0,0,0,5,5,0,NA,NA
"2215","NY","512","Troy/Rensselaer County CoC",225,176,49,142,142,0,54,54,0,2012,54,26,28,8,5,3,NA,NA
"2216","NY","513","Wayne, Ontario, Seneca, Yates Counties CoC",121,121,0,37,37,0,13,13,0,2012,5,5,0,39,39,0,NA,NA
"2217","NY","514","Jamestown, Dunkirk/Chautauqua County CoC",33,33,0,6,6,0,3,3,0,2012,0,0,0,0,0,0,NA,NA
"2218","NY","516","Clinton County CoC",236,219,17,87,82,5,31,29,2,2012,36,36,0,14,6,8,NA,NA
"2219","NY","518","Utica, Rome/Oneida, Madison Counties CoC",176,154,22,91,77,14,36,33,3,2012,19,15,4,8,6,2,NA,NA
"2220","NY","519","Columbia, Greene Counties CoC",132,132,0,72,72,0,23,23,0,2012,5,5,0,4,4,0,NA,NA
"2221","NY","520","Franklin, Essex Counties CoC",14,5,9,0,0,0,0,0,0,2012,7,0,7,0,0,0,NA,NA
"2222","NY","522","Jefferson, Lewis, St. Lawrence Counties CoC",95,81,14,13,8,5,6,4,2,2012,16,10,6,34,33,1,NA,NA
"2223","NY","523","Glens Falls, Saratoga Springs/Saratoga, Washington, Warren, Hamilton Counties Co",299,262,37,125,112,13,44,39,5,2012,51,37,14,38,34,4,NA,NA
"2224","NY","600","New York City CoC",56672,53410,3262,33129,33129,0,10045,10045,0,2012,3277,1189,2088,3790,3266,524,NA,NA
"2225","NY","601","Poughkeepsie/Dutchess County CoC",453,409,44,205,202,3,82,81,1,2012,44,12,32,15,13,2,NA,NA
"2226","NY","602","Newburgh, Middletown/Orange County CoC",502,356,146,179,179,0,58,58,0,2012,117,54,63,13,7,6,NA,NA
"2227","NY","603","Nassau, Suffolk Counties CoC",3359,3224,135,2277,2277,0,697,697,0,2012,312,291,21,407,401,6,NA,NA
"2228","NY","604","Yonkers, Mount Vernon/Westchester County CoC",1741,1703,38,1015,1015,0,359,359,0,2012,309,275,34,223,218,5,NA,NA
"2229","NY","606","Rockland County CoC",107,104,3,30,30,0,11,11,0,2012,4,1,3,6,6,0,NA,NA
"2230","NY","607","Sullivan County CoC",630,618,12,373,369,4,116,115,1,2012,52,52,0,6,6,0,NA,NA
"2231","NY","608","Kingston/Ulster County CoC",355,291,64,186,184,2,58,57,1,2012,21,7,14,9,4,5,NA,NA
"2232","OH","500","Cincinnati/Hamilton County CoC",1654,1608,46,767,767,0,213,213,0,2012,234,221,13,200,194,6,NA,NA
"2233","OH","501","Toledo/Lucas County CoC",977,840,137,327,320,7,108,105,3,2012,138,99,39,71,49,22,NA,NA
"2234","OH","502","Cleveland/Cuyahoga County CoC",2191,2067,124,565,565,0,187,187,0,2012,375,296,79,334,312,22,NA,NA
"2235","OH","503","Columbus/Franklin County CoC",1434,1252,182,366,366,0,116,116,0,2012,311,174,137,133,126,7,NA,NA
"2236","OH","504","Youngstown/Mahoning County CoC",224,214,10,138,138,0,45,45,0,2012,54,47,7,12,9,3,NA,NA
"2237","OH","505","Dayton, Kettering/Montgomery County CoC",1081,1014,67,442,442,0,147,147,0,2012,48,37,11,136,124,12,NA,NA
"2238","OH","506","Akron, Barberton/Summit County CoC",813,647,166,303,296,7,95,92,3,2012,208,113,95,91,33,58,NA,NA
"2239","OH","507","Ohio Balance of State CoC",5121,4185,936,2984,2693,291,951,859,92,2012,530,324,206,225,159,66,NA,NA
"2240","OH","508","Canton, Massillon, Alliance/Stark County CoC",482,419,63,230,227,3,81,80,1,2012,84,56,28,42,28,14,NA,NA
"2241","OK","500","North Central Oklahoma CoC",204,147,57,96,76,20,36,30,6,2012,24,17,7,7,4,3,NA,NA
"2242","OK","501","Tulsa City & County CoC",1021,876,145,217,217,0,62,62,0,2012,88,84,4,173,154,19,NA,NA
"2243","OK","502","Oklahoma City CoC",1303,942,361,234,220,14,81,77,4,2012,235,59,176,155,109,46,NA,NA
"2244","OK","503","Oklahoma Balance of State CoC",571,144,427,286,94,192,80,43,37,2012,32,0,32,22,3,19,NA,NA
"2245","OK","504","Norman/Cleveland County CoC",616,160,456,183,92,91,58,30,28,2012,44,20,24,2,2,0,NA,NA
"2246","OK","505","Northeast Oklahoma CoC",342,277,65,125,93,32,45,36,9,2012,92,82,10,14,14,0,NA,NA
"2247","OK","506","Southwest Oklahoma Regional CoC",396,233,163,175,83,92,73,27,46,2012,6,6,0,16,5,11,NA,NA
"2248","OK","507","Southeastern Oklahoma Regional CoC",579,264,315,262,95,167,84,30,54,2012,48,19,29,15,8,7,NA,NA
"2249","OR","500","Eugene, Springfield/Lane County CoC",2057,651,1406,518,285,233,157,88,69,2012,628,79,549,264,78,186,NA,NA
"2250","OR","501","Portland, Gresham/Multnomah County CoC",4423,2709,1714,1505,1393,112,620,565,55,2012,1090,304,786,380,162,218,NA,NA
"2251","OR","502","Medford, Ashland/Jackson County CoC",691,441,250,131,122,9,41,37,4,2012,172,55,117,136,123,13,NA,NA
"2252","OR","503","Central Oregon CoC",808,276,532,348,125,223,111,38,73,2012,131,14,117,82,20,62,NA,NA
"2253","OR","505","Oregon Balance of State CoC",6105,2035,4070,2763,803,1960,922,308,614,2012,949,271,678,314,134,180,NA,NA
"2254","OR","506","Hillsboro, Beaverton/Washington County CoC",751,309,442,352,220,132,112,73,39,2012,160,12,148,103,39,64,NA,NA
"2255","OR","507","Clackamas County CoC",993,124,869,423,105,318,147,37,110,2012,172,19,153,77,2,75,NA,NA
"2256","PA","500","Philadelphia CoC",5780,5280,500,2804,2804,0,923,923,0,2012,1037,257,780,394,320,74,NA,NA
"2257","PA","501","Harrisburg/Dauphin County CoC",386,328,58,151,149,2,58,57,1,2012,65,37,28,45,41,4,NA,NA
"2258","PA","502","Upper Darby, Chester, Haverford/Delaware County CoC",604,566,38,360,360,0,100,100,0,2012,64,45,19,17,14,3,NA,NA
"2259","PA","503","Wilkes-Barre, Hazleton/Luzerne County CoC",178,173,5,84,84,0,32,32,0,2012,5,3,2,22,22,0,NA,NA
"2260","PA","504","Lower Merion, Norristown, Abington/Montgomery County CoC",419,396,23,271,271,0,87,87,0,2012,52,38,14,12,9,3,NA,NA
"2261","PA","505","Chester County CoC",691,667,24,215,215,0,70,70,0,2012,69,62,7,304,300,4,NA,NA
"2262","PA","506","Reading/Berks County CoC",340,323,17,124,115,9,44,43,1,2012,55,47,8,30,28,2,NA,NA
"2263","PA","508","Scranton/Lackawanna County CoC",260,238,22,168,168,0,59,59,0,2012,31,16,15,33,31,2,NA,NA
"2264","PA","509","Eastern Pennsylvania CoC",1752,1621,131,1088,1075,13,362,359,3,2012,121,91,30,88,70,18,NA,NA
"2265","PA","510","Lancaster City & County CoC",562,553,9,321,321,0,104,104,0,2012,49,44,5,68,65,3,NA,NA
"2266","PA","511","Bristol, Bensalem/Bucks County CoC",458,407,51,316,314,2,107,106,1,2012,30,3,27,14,5,9,NA,NA
"2267","PA","512","York City & County CoC",284,259,25,155,148,7,50,47,3,2012,51,46,5,15,13,2,NA,NA
"2268","PA","600","Pittsburgh, McKeesport, Penn Hills/Allegheny County CoC",1376,1320,56,560,560,0,197,197,0,2012,271,239,32,214,206,8,NA,NA
"2269","PA","601","Western Pennsylvania CoC",1097,1031,66,531,502,29,176,166,10,2012,140,133,7,180,178,2,NA,NA
"2270","PA","603","Beaver County CoC",110,105,5,45,43,2,15,14,1,2012,8,5,3,2,2,0,NA,NA
"2271","PA","605","Erie City & County CoC",439,393,46,248,215,33,92,77,15,2012,58,55,3,18,17,1,NA,NA
"2272","RI","500","Rhode Island Statewide CoC",1277,1249,28,489,489,0,182,182,0,2012,154,154,0,96,96,0,NA,NA
"2273","SC","500","Charleston/Low Country CoC",483,271,212,67,63,4,26,25,1,2012,58,15,43,124,98,26,NA,NA
"2274","SC","501","Greenville, Anderson, Spartanburg/Upstate CoC",1324,1139,185,538,538,0,194,194,0,2012,57,56,1,115,91,24,NA,NA
"2275","SC","502","Columbia/Midlands CoC",1648,946,702,342,259,83,126,98,28,2012,174,31,143,226,111,115,NA,NA
"2276","SC","503","Myrtle Beach, Sumter City & County CoC",1460,420,1040,641,127,514,205,54,151,2012,239,12,227,78,20,58,NA,NA
"2277","SD","500","South Dakota Statewide CoC",859,795,64,347,330,17,119,115,4,2012,138,125,13,124,114,10,NA,NA
"2278","TN","500","Chattanooga/Southeast Tennessee CoC",548,374,174,184,118,66,61,39,22,2012,70,55,15,60,45,15,NA,NA
"2279","TN","501","Memphis/Shelby County CoC",2076,1750,326,690,686,4,214,213,1,2012,265,76,189,411,384,27,NA,NA
"2280","TN","502","Knoxville/Knox County CoC",854,721,133,82,76,6,34,32,2,2012,174,132,42,82,62,20,NA,NA
"2281","TN","503","Central Tennessee CoC",245,232,13,55,52,3,21,20,1,2012,29,27,2,41,39,2,NA,NA
"2282","TN","504","Nashville-Davidson County CoC",1934,1571,363,244,244,0,81,81,0,2012,1055,695,360,393,285,108,NA,NA
"2283","TN","506","Upper Cumberland CoC",658,159,499,178,39,139,63,13,50,2012,39,2,37,24,6,18,NA,NA
"2284","TN","507","Jackson/West Tennessee CoC",1692,230,1462,621,105,516,215,40,175,2012,256,37,219,96,11,85,NA,NA
"2285","TN","509","Appalachian Regional CoC",424,323,101,121,92,29,39,33,6,2012,56,31,25,122,116,6,NA,NA
"2286","TN","510","Murfreesboro/Rutherford County CoC",218,122,96,69,58,11,20,17,3,2012,75,9,66,19,11,8,NA,NA
"2287","TN","512","Morristown/Blount, Sevier, Campbell, Cocke Counties CoC",777,296,481,277,141,136,85,45,40,2012,247,62,185,37,14,23,NA,NA
"2288","TX","500","San Antonio/Bexar County CoC",3670,2043,1627,2381,1544,837,1023,643,380,2012,539,285,254,286,221,65,NA,NA
"2289","TX","503","Austin/Travis County CoC",2244,1375,869,672,658,14,213,210,3,2012,733,292,441,353,146,207,NA,NA
"2290","TX","600","Dallas City & County, Irving CoC",3447,3242,205,1849,1836,13,471,465,6,2012,442,298,144,409,346,63,NA,NA
"2291","TX","601","Fort Worth, Arlington/Tarrant County CoC",2123,1987,136,854,852,2,327,326,1,2012,225,187,38,164,136,28,NA,NA
"2292","TX","603","El Paso City & County CoC",1236,1054,182,494,494,0,147,147,0,2012,115,75,40,112,65,47,NA,NA
"2293","TX","604","Waco/McLennan County CoC",319,258,61,157,152,5,36,35,1,2012,34,2,32,58,41,17,NA,NA
"2294","TX","607","Texas Balance of State CoC",12764,3342,9422,5037,1390,3647,1650,542,1108,2012,2895,670,2225,1728,461,1267,NA,NA
"2295","TX","611","Amarillo CoC",528,477,51,145,145,0,45,45,0,2012,77,55,22,79,75,4,NA,NA
"2296","TX","624","Wichita Falls/Wise, Palo Pinto, Wichita, Archer Counties CoC",226,169,57,44,38,6,14,12,2,2012,118,88,30,6,6,0,NA,NA
"2297","TX","700","Houston, Pasadena, Conroe/Harris, Ft. Bend, Montgomery, Counties CoC",7187,3363,3824,1566,1282,284,540,427,113,2012,1422,178,1244,1162,380,782,NA,NA
"2298","TX","701","Bryan, College Station/Brazos Valley CoC",308,191,117,110,80,30,45,38,7,2012,50,50,0,7,7,0,NA,NA
"2299","UT","500","Salt Lake City & County CoC",2463,2273,190,997,981,16,292,287,5,2012,317,253,64,259,244,15,NA,NA
"2300","UT","503","Utah Balance of State CoC",879,684,195,426,382,44,135,123,12,2012,99,44,55,62,47,15,NA,NA
"2301","UT","504","Provo/Mountainland CoC",185,95,90,55,48,7,18,16,2,2012,27,2,25,9,6,3,NA,NA
"2302","VA","500","Richmond/Henrico, Chesterfield, Hanover Counties CoC",933,858,75,186,182,4,70,69,1,2012,76,43,33,158,146,12,NA,NA
"2303","VA","501","Norfolk/Chesapeake, Suffolk, Isle of Wight, Southampton Counties CoC",652,567,85,196,194,2,68,67,1,2012,83,49,34,77,59,18,NA,NA
"2304","VA","502","Roanoke City & County, Salem CoC",561,523,38,132,132,0,50,50,0,2012,149,140,9,72,71,1,NA,NA
"2305","VA","503","Virginia Beach CoC",440,349,91,196,196,0,66,66,0,2012,62,40,22,65,45,20,NA,NA
"2306","VA","504","Charlottesville CoC",191,164,27,40,40,0,19,19,0,2012,76,54,22,12,12,0,NA,NA
"2307","VA","505","Newport News, Hampton/Virginia Peninsula CoC",681,620,61,195,195,0,63,63,0,2012,170,134,36,223,212,11,NA,NA
"2308","VA","507","Portsmouth CoC",332,154,178,84,71,13,30,26,4,2012,42,21,21,23,13,10,NA,NA
"2309","VA","508","Lynchburg CoC",214,145,69,67,55,12,26,22,4,2012,43,21,22,22,11,11,NA,NA
"2310","VA","513","Harrisburg, Winchester/Western Virginia CoC",313,262,51,131,123,8,41,39,2,2012,80,67,13,26,19,7,NA,NA
"2311","VA","514","Fredericksburg/Spotsylvania, Stafford Counties CoC",193,146,47,84,79,5,28,26,2,2012,63,25,38,15,10,5,NA,NA
"2312","VA","521","Virginia Balance of State CoC",957,742,215,472,415,57,161,139,22,2012,131,68,63,47,31,16,NA,NA
"2313","VA","600","Arlington County CoC",451,320,131,188,188,0,60,60,0,2012,175,82,93,24,16,8,NA,NA
"2314","VA","601","Fairfax County CoC",1534,1356,178,837,837,0,249,249,0,2012,358,230,128,60,50,10,NA,NA
"2315","VA","602","Loudoun County CoC",168,132,36,98,91,7,30,28,2,2012,18,7,11,8,5,3,NA,NA
"2316","VA","603","Alexandria CoC",352,330,22,139,139,0,49,49,0,2012,60,40,20,20,15,5,NA,NA
"2317","VA","604","Prince William County CoC",452,327,125,295,259,36,84,74,10,2012,60,21,39,29,12,17,NA,NA
"2318","VT","500","Vermont Balance of State CoC",776,630,146,338,297,41,111,97,14,2012,127,108,19,80,71,9,NA,NA
"2319","VT","501","Burlington/Chittenden County CoC",384,307,77,169,157,12,61,56,5,2012,101,45,56,29,22,7,NA,NA
"2320","WA","500","Seattle/King County CoC",8899,6281,2618,3151,3127,24,952,944,8,2012,846,618,228,796,633,163,NA,NA
"2321","WA","501","Washington Balance of State CoC",5342,3698,1644,2508,2155,353,805,702,103,2012,811,332,479,352,241,111,NA,NA
"2322","WA","502","Spokane City & County CoC",1185,1055,130,523,485,38,170,158,12,2012,82,59,23,99,89,10,NA,NA
"2323","WA","503","Tacoma, Lakewood/Pierce County CoC",1997,1805,192,1310,1291,19,374,370,4,2012,219,111,108,91,61,30,NA,NA
"2324","WA","504","Everett/Snohomish County CoC",2061,1344,717,1159,1011,148,389,343,46,2012,172,69,103,88,42,46,NA,NA
"2325","WA","508","Vancouver/Clark County CoC",1020,844,176,580,514,66,181,159,22,2012,83,38,45,49,31,18,NA,NA
"2326","WI","500","Wisconsin Balance of State CoC",3618,3239,379,2062,1911,151,654,599,55,2012,233,197,36,280,278,2,NA,NA
"2327","WI","501","Milwaukee City & County CoC",1432,1318,114,517,506,11,174,171,3,2012,129,77,52,199,191,8,NA,NA
"2328","WI","502","Racine City & County CoC",241,230,11,99,99,0,32,32,0,2012,10,10,0,35,35,0,NA,NA
"2329","WI","503","Madison/Dane County CoC",736,659,77,316,311,5,101,100,1,2012,115,77,38,25,21,4,NA,NA
"2330","WV","500","Wheeling, Weirton Area CoC",116,106,10,31,31,0,12,12,0,2012,58,44,14,10,10,0,NA,NA
"2331","WV","501","Huntington/Cabell, Wayne Counties CoC",274,235,39,98,98,0,27,27,0,2012,37,23,14,21,13,8,NA,NA
"2332","WV","503","Charleston/Kanawha, Putnam, Boone, Clay Counties CoC",416,358,58,110,107,3,40,39,1,2012,64,49,15,47,38,9,NA,NA
"2333","WV","508","West Virginia Balance of State CoC",1604,834,770,429,264,165,164,87,77,2012,251,99,152,190,158,32,NA,NA
"2334","WY","500","Wyoming Statewide CoC",1813,475,1338,511,183,328,171,57,114,2012,452,99,353,311,128,183,NA,NA
"2335",NA,NA,"Total",621553,390155,231398,239397,190996,48401,77155,61796,15359,2012,112037,39560,72477,60579,35143,25436,NA,NA
"2336","AK","500","Anchorage CoC",1122,1070,52,278,278,0,87,87,0,2013,89,68,21,144,138,6,NA,NA
"2337","AK","501","Alaska Balance of State CoC",824,671,153,306,255,51,109,95,14,2013,95,70,25,66,50,16,NA,NA
"2338","AL","500","Birmingham/Jefferson, St. Clair, Shelby Counties CoC",1469,960,509,380,283,97,131,88,43,2013,427,156,271,194,155,39,NA,NA
"2339","AL","501","Mobile City & County/Baldwin County CoC",493,260,233,150,138,12,51,46,5,2013,91,10,81,41,5,36,NA,NA
"2340","AL","502","Florence/Northwest Alabama CoC",223,197,26,90,81,9,24,22,2,2013,30,10,20,2,0,2,NA,NA
"2341","AL","503","Huntsville/North Alabama CoC",586,409,177,129,114,15,41,37,4,2013,120,46,74,77,33,44,NA,NA
"2342","AL","504","Montgomery City & County CoC",515,399,116,69,69,0,21,21,0,2013,69,11,58,59,44,15,NA,NA
"2343","AL","505","Gadsden/Northeast Alabama CoC",399,329,70,124,98,26,61,48,13,2013,40,20,20,31,26,5,NA,NA
"2344","AL","506","Tuscaloosa City & County CoC",99,95,4,27,27,0,6,6,0,2013,9,5,4,66,66,0,NA,NA
"2345","AL","507","Alabama Balance of State CoC",905,597,308,333,224,109,160,107,53,2013,72,37,35,41,34,7,NA,NA
"2346","AR","500","Little Rock/Central Arkansas CoC",1066,563,503,80,80,0,27,27,0,2013,373,69,304,260,204,56,NA,NA
"2347","AR","501","Fayetteville/Northwest Arkansas CoC",668,446,222,289,244,45,98,83,15,2013,65,27,38,147,90,57,NA,NA
"2348","AR","503","Arkansas  Balance of State  CoC",1760,470,1290,157,122,35,51,40,11,2013,114,53,61,46,27,19,NA,NA
"2349","AR","504","Delta Hills CoC",254,122,132,82,11,71,33,3,30,2013,46,18,28,9,5,4,NA,NA
"2350","AR","505","Southeast Arkansas CoC",64,63,1,30,30,0,9,9,0,2013,4,4,0,0,0,0,NA,NA
"2351","AR","512","Boone, Baxter, Marion, Newton Counties CoC",NA,NA,NA,NA,NA,NA,NA,NA,NA,2013,NA,NA,NA,NA,NA,NA,NA,NA
"2352","AZ","500","Arizona Balance of State CoC",2435,1386,1049,987,811,176,281,230,51,2013,329,168,161,389,264,125,NA,NA
"2353","AZ","501","Tucson/Pima County CoC",2238,1737,501,636,618,18,209,201,8,2013,360,166,194,322,249,73,NA,NA
"2354","AZ","502","Phoenix, Mesa/Maricopa County CoC",5889,4308,1581,2429,2340,89,801,779,22,2013,499,186,313,511,388,123,NA,NA
"2355","CA","500","San Jose/Santa Clara City & County CoC",7631,1957,5674,1067,1011,56,349,332,17,2013,2518,259,2259,718,139,579,NA,NA
"2356","CA","501","San Francisco CoC",7008,2693,4315,679,646,33,229,218,11,2013,2093,583,1510,716,294,422,NA,NA
"2357","CA","502","Oakland, Berkeley/Alameda County CoC",4264,1927,2337,1342,1124,218,462,420,42,2013,1054,200,854,492,139,353,NA,NA
"2358","CA","503","Sacramento City & County CoC",2538,1752,786,801,796,5,249,248,1,2013,440,155,285,302,166,136,NA,NA
"2359","CA","504","Santa Rosa, Petaluma/Sonoma County CoC",4280,971,3309,451,397,54,152,136,16,2013,1168,134,1034,400,57,343,NA,NA
"2360","CA","505","Richmond/Contra Costa County CoC",2000,671,1329,297,297,0,102,102,0,2013,754,160,594,188,53,135,NA,NA
"2361","CA","506","Salinas/Monterey, San Benito Counties CoC",2955,749,2206,663,382,281,247,121,126,2013,1038,178,860,250,89,161,NA,NA
"2362","CA","507","Marin County CoC",676,505,171,238,238,0,78,78,0,2013,89,26,63,54,28,26,NA,NA
"2363","CA","508","Watsonville/Santa Cruz City & County CoC",3536,641,2895,544,343,201,165,104,61,2013,989,74,915,395,52,343,NA,NA
"2364","CA","509","Mendocino County CoC",1392,174,1218,125,45,80,34,16,18,2013,227,29,198,55,15,40,NA,NA
"2365","CA","510","Turlock, Modesto/Stanislaus County CoC",1201,556,645,260,97,163,74,33,41,2013,205,65,140,87,44,43,NA,NA
"2366","CA","511","Stockton/San Joaquin County CoC",1541,1278,263,747,722,25,230,222,8,2013,204,137,67,83,61,22,NA,NA
"2367","CA","512","Daly/San Mateo County CoC",1995,696,1299,621,377,244,180,115,65,2013,889,32,857,245,114,131,NA,NA
"2368","CA","513","Visalia/Kings, Tulare Counties CoC",705,409,296,158,150,8,47,45,2,2013,187,11,176,43,14,29,NA,NA
"2369","CA","514","Fresno City & County/Madera County CoC",3131,594,2537,710,308,402,302,101,201,2013,793,44,749,338,81,257,NA,NA
"2370","CA","515","Roseville, Rocklin/Placer, Nevada Counties CoC",908,385,523,219,174,45,77,61,16,2013,222,39,183,92,32,60,NA,NA
"2371","CA","516","Redding/Shasta, Siskiyou, Lassen, Plumas, Del Norte, Modoc, Sierra Counties CoC",851,504,347,220,143,77,60,44,16,2013,199,87,112,203,117,86,NA,NA
"2372","CA","517","Napa City & County CoC",245,177,68,77,77,0,26,26,0,2013,81,46,35,19,9,10,NA,NA
"2373","CA","518","Vallejo/Solano County CoC",1329,440,889,166,114,52,70,49,21,2013,414,109,305,88,55,33,NA,NA
"2374","CA","519","Chico, Paradise/Butte County CoC",712,289,423,113,103,10,34,30,4,2013,312,48,264,101,46,55,NA,NA
"2375","CA","520","Merced City & County CoC",372,117,255,27,27,0,11,11,0,2013,181,59,122,26,6,20,NA,NA
"2376","CA","521","Davis, Woodland/Yolo County CoC",474,276,198,129,129,0,36,36,0,2013,134,37,97,44,24,20,NA,NA
"2377","CA","522","Humboldt County CoC",864,180,684,264,83,181,64,26,38,2013,276,26,250,129,49,80,NA,NA
"2378","CA","523","Colusa, Glenn, Trinity Counties CoC",696,272,424,209,121,88,65,39,26,2013,303,85,218,67,25,42,NA,NA
"2379","CA","524","Yuba City & County/Sutter County CoC",1485,1106,379,735,566,169,319,247,72,2013,104,51,53,32,24,8,NA,NA
"2380","CA","525","El Dorado County CoC",180,131,49,39,35,4,17,15,2,2013,55,17,38,6,5,1,NA,NA
"2381","CA","526","Amador, Calaveras, Mariposa, Tuolumne Counties CoC",376,136,240,119,104,15,34,30,4,2013,130,20,110,37,9,28,NA,NA
"2382","CA","600","Los Angeles City & County CoC",35524,12934,22590,6678,4607,2071,2223,1539,684,2013,8702,1191,7511,4007,1450,2557,NA,NA
"2383","CA","601","San Diego City and County CoC",8879,4305,4574,1866,1688,178,597,548,49,2013,2531,234,2297,1486,798,688,NA,NA
"2384","CA","602","Santa Ana, Anaheim/Orange County CoC",4251,2573,1678,1539,1536,3,523,522,1,2013,829,156,673,446,177,269,NA,NA
"2385","CA","603","Santa Maria/Santa Barbara County CoC",1882,904,978,418,308,110,122,88,34,2013,913,379,534,124,48,76,NA,NA
"2386","CA","604","Bakersfield/Kern County CoC",1152,547,605,228,174,54,73,53,20,2013,286,41,245,135,70,65,NA,NA
"2387","CA","606","Long Beach CoC",2847,968,1879,525,268,257,169,88,81,2013,1112,153,959,527,363,164,NA,NA
"2388","CA","607","Pasadena CoC",772,379,393,269,170,99,93,61,32,2013,217,12,205,61,16,45,NA,NA
"2389","CA","608","Riverside City & County CoC",2978,1090,1888,604,460,144,180,135,45,2013,1117,47,1070,285,104,181,NA,NA
"2390","CA","609","San Bernardino City & County CoC",2321,1074,1247,920,790,130,192,156,36,2013,596,114,482,184,52,132,NA,NA
"2391","CA","611","Oxnard, San Buenaventura/Ventura County CoC",1674,600,1074,380,226,154,114,67,47,2013,797,62,735,140,22,118,NA,NA
"2392","CA","612","Glendale CoC",318,211,107,118,114,4,39,38,1,2013,108,62,46,23,11,12,NA,NA
"2393","CA","613","Imperial County CoC",252,148,104,91,85,6,30,28,2,2013,138,52,86,7,4,3,NA,NA
"2394","CA","614","San Luis Obispo County CoC",2357,235,2122,438,93,345,199,30,169,2013,707,37,670,260,24,236,NA,NA
"2395","CO","500","Colorado Balance of State CoC",2267,1262,1005,992,704,288,313,230,83,2013,579,165,414,177,84,93,NA,NA
"2396","CO","503","Metropolitan Denver CoC",6316,5388,928,3707,3436,271,1013,940,73,2013,889,519,370,358,267,91,NA,NA
"2397","CO","504","Colorado Springs/El Paso County CoC",1171,941,230,391,376,15,118,114,4,2013,312,162,150,150,101,49,NA,NA
"2398","CT","503","Bridgeport, Stamford, Norwalk/Fairfield County CoC",1059,748,311,334,297,37,116,101,15,2013,252,137,115,84,67,17,NA,NA
"2399","CT","505","Connecticut Balance of State CoC",3389,2781,608,1013,957,56,359,337,22,2013,794,541,253,257,200,57,NA,NA
"2400","DE","500","Delaware Statewide CoC",946,936,10,371,371,0,119,119,0,2013,71,68,3,89,86,3,NA,NA
"2401","FL","500","Sarasota, Bradenton/Manatee, Sarasota Counties CoC",1049,563,486,201,160,41,69,58,11,2013,301,18,283,101,51,50,NA,NA
"2402","FL","501","Tampa/Hillsborough County CoC",1909,965,944,583,312,271,201,113,88,2013,506,145,361,170,76,94,NA,NA
"2403","FL","502","St. Petersburg, Clearwater, Largo/Pinellas County CoC",3913,1826,2087,725,225,500,216,73,143,2013,375,135,240,618,378,240,NA,NA
"2404","FL","503","Lakeland, Winterhaven/Polk County CoC",520,325,195,115,115,0,37,37,0,2013,172,66,106,45,16,29,NA,NA
"2405","FL","504","Daytona Beach, Daytona/Volusia, Flagler Counties CoC",2176,693,1483,397,367,30,138,126,12,2013,259,3,256,380,51,329,NA,NA
"2406","FL","505","Fort Walton Beach/Okaloosa, Walton Counties CoC",1658,383,1275,1091,163,928,429,70,359,2013,352,39,313,265,99,166,NA,NA
"2407","FL","506","Tallahassee/Leon County CoC",974,749,225,164,164,0,79,79,0,2013,259,130,129,160,114,46,NA,NA
"2408","FL","507","Orlando/Orange, Osceola, Seminole Counties CoC",4378,2321,2057,1323,1037,286,414,316,98,2013,1577,238,1339,611,257,354,NA,NA
"2409","FL","508","Gainesville/Alachua, Putnam Counties CoC",1718,413,1305,644,82,562,280,25,255,2013,528,226,302,300,152,148,NA,NA
"2410","FL","509","Fort Pierce/St. Lucie, Indian River, Martin Counties CoC",2240,224,2016,1374,186,1188,377,61,316,2013,196,6,190,94,0,94,NA,NA
"2411","FL","510","Jacksonville-Duval, Clay Counties CoC",2768,1671,1097,830,708,122,232,205,27,2013,365,186,179,324,204,120,NA,NA
"2412","FL","511","Pensacola/Escambia, Santa Rosa Counties CoC",945,563,382,156,144,12,62,59,3,2013,243,53,190,168,95,73,NA,NA
"2413","FL","512","St. Johns County CoC",1437,233,1204,334,112,222,120,47,73,2013,56,8,48,49,12,37,NA,NA
"2414","FL","513","Palm Bay, Melbourne/Brevard County CoC",1567,707,860,502,385,117,159,116,43,2013,115,5,110,262,140,122,NA,NA
"2415","FL","514","Ocala/Marion County CoC",530,325,205,157,99,58,66,38,28,2013,91,1,90,120,52,68,NA,NA
"2416","FL","515","Panama City/Bay, Jackson Counties CoC",301,201,100,43,35,8,15,12,3,2013,38,0,38,27,11,16,NA,NA
"2417","FL","517","Hendry, Hardee, Highlands Counties CoC",3847,136,3711,2472,109,2363,864,34,830,2013,681,14,667,257,3,254,NA,NA
"2418","FL","518","Columbia, Hamilton, Lafayette, Suwannee Counties CoC",1278,81,1197,495,25,470,222,12,210,2013,289,19,270,177,27,150,NA,NA
"2419","FL","519","Pasco County CoC",3305,105,3200,1652,42,1610,806,21,785,2013,1200,13,1187,368,35,333,NA,NA
"2420","FL","520","Citrus, Hernando, Lake, Sumter Counties CoC",709,303,406,271,128,143,84,43,41,2013,46,5,41,49,25,24,NA,NA
"2421","FL","600","Miami-Dade County CoC",3802,2963,839,1317,1317,0,421,421,0,2013,618,199,419,253,193,60,NA,NA
"2422","FL","601","Ft Lauderdale/Broward County CoC",2810,1981,829,910,894,16,289,285,4,2013,411,149,262,225,128,97,NA,NA
"2423","FL","602","Punta Gorda/Charlotte County CoC",573,186,387,144,101,43,47,36,11,2013,211,19,192,109,21,88,NA,NA
"2424","FL","603","Ft Myers, Cape Coral/Lee County CoC",848,452,396,149,115,34,42,35,7,2013,180,58,122,70,39,31,NA,NA
"2425","FL","604","Monroe County CoC",652,347,305,67,63,4,23,21,2,2013,173,63,110,108,57,51,NA,NA
"2426","FL","605","West Palm Beach/Palm Beach County CoC",1559,612,947,276,146,130,78,42,36,2013,373,49,324,168,75,93,NA,NA
"2427","FL","606","Naples/Collier County CoC",396,342,54,111,106,5,36,35,1,2013,32,26,6,27,17,10,NA,NA
"2428","GA","500","Atlanta CoC",5536,3803,1733,580,541,39,187,175,12,2013,1431,629,802,983,655,328,NA,NA
"2429","GA","501","Georgia Balance of State CoC",7651,2334,5317,2380,1646,734,708,466,242,2013,1136,169,967,496,58,438,NA,NA
"2430","GA","502","Fulton County CoC",428,298,130,222,222,0,77,77,0,2013,55,12,43,33,22,11,NA,NA
"2431","GA","503","Athens-Clarke County CoC",213,118,95,42,42,0,14,14,0,2013,67,22,45,15,3,12,NA,NA
"2432","GA","504","Augusta-Richmond County CoC",476,330,146,163,137,26,41,36,5,2013,62,14,48,42,26,16,NA,NA
"2433","GA","505","Columbus-Muscogee/Russell County CoC",294,234,60,48,48,0,19,19,0,2013,58,32,26,42,29,13,NA,NA
"2434","GA","506","Marietta/Cobb County CoC",495,351,144,232,210,22,76,71,5,2013,60,16,44,59,25,34,NA,NA
"2435","GA","507","Savannah/Chatham County CoC",1165,543,622,113,113,0,40,40,0,2013,131,42,89,68,39,29,NA,NA
"2436","GA","508","DeKalb County CoC",713,499,214,311,301,10,95,92,3,2013,82,0,82,67,43,24,NA,NA
"2437","HI","500","Hawaii Balance of State CoC",1779,654,1125,620,413,207,168,118,50,2013,395,45,350,160,27,133,NA,NA
"2438","HI","501","Honolulu City and County CoC",4556,3091,1465,2360,2190,170,568,525,43,2013,785,228,557,398,207,191,NA,NA
"2439","IA","500","Sioux City/Dakota, Woodbury Counties CoC",236,224,12,121,121,0,45,45,0,2013,65,57,8,11,9,2,NA,NA
"2440","IA","501","Iowa Balance of State CoC",1920,1859,61,1087,1085,2,344,343,1,2013,145,129,16,88,85,3,NA,NA
"2441","IA","502","Des Moines/Polk County CoC",928,867,61,352,352,0,106,106,0,2013,117,72,45,130,126,4,NA,NA
"2442","ID","500","Boise/Ada County CoC",694,645,49,150,147,3,39,38,1,2013,108,93,15,112,106,6,NA,NA
"2443","ID","501","Idaho Balance of State CoC",1087,759,328,547,482,65,172,154,18,2013,163,72,91,96,56,40,NA,NA
"2444","IL","500","McHenry County CoC",185,180,5,74,74,0,24,24,0,2013,9,8,1,25,25,0,NA,NA
"2445","IL","501","Rockford/Winnebago, Boone Counties CoC",788,501,287,382,207,175,106,65,41,2013,268,153,115,45,32,13,NA,NA
"2446","IL","502","Waukegan, North Chicago/Lake County CoC",497,492,5,160,160,0,53,53,0,2013,62,61,1,82,82,0,NA,NA
"2447","IL","503","Champaign, Urbana, Rantoul/Champaign County CoC",214,171,43,58,41,17,15,11,4,2013,8,4,4,31,28,3,NA,NA
"2448","IL","504","Madison County CoC",201,173,28,155,144,11,44,41,3,2013,7,1,6,7,4,3,NA,NA
"2449","IL","506","Joliet, Bolingbrook/Will County CoC",288,281,7,104,104,0,32,32,0,2013,17,11,6,30,30,0,NA,NA
"2450","IL","507","Peoria, Pekin/Fulton, Tazewell, Peoria, Woodford Counties CoC",396,370,26,144,140,4,48,46,2,2013,52,51,1,26,23,3,NA,NA
"2451","IL","508","East St. Louis, Belleville/St. Clair County CoC",213,146,67,92,92,0,31,31,0,2013,24,0,24,41,29,12,NA,NA
"2452","IL","509","Dekalb City & County CoC",107,104,3,61,61,0,19,19,0,2013,0,0,0,0,0,0,NA,NA
"2453","IL","510","Chicago CoC",6276,5060,1216,2353,2331,22,735,730,5,2013,557,257,300,712,406,306,NA,NA
"2454","IL","511","Cook County CoC",1242,1091,151,549,544,5,176,175,1,2013,109,79,30,121,100,21,NA,NA
"2455","IL","512","Bloomington/Central Illinois CoC",536,420,116,183,127,56,75,47,28,2013,62,57,5,15,7,8,NA,NA
"2456","IL","513","Springfield/Sangamon County CoC",280,270,10,99,99,0,31,31,0,2013,87,78,9,23,22,1,NA,NA
"2457","IL","514","DuPage County CoC",665,636,29,370,370,0,120,120,0,2013,74,69,5,19,16,3,NA,NA
"2458","IL","515","South Central Illinois CoC",149,130,19,109,101,8,37,33,4,2013,21,10,11,4,3,1,NA,NA
"2459","IL","516","Decatur/Macon County CoC",247,190,57,103,95,8,35,32,3,2013,69,38,31,12,10,2,NA,NA
"2460","IL","517","Aurora, Elgin/Kane County CoC",451,405,46,107,107,0,32,32,0,2013,109,88,21,37,31,6,NA,NA
"2461","IL","518","Rock Island, Moline/Northwestern Illinois CoC",219,218,1,97,97,0,36,36,0,2013,0,0,0,9,9,0,NA,NA
"2462","IL","519","West Central Illinois CoC",133,128,5,89,89,0,22,22,0,2013,4,4,0,5,5,0,NA,NA
"2463","IL","520","Southern Illinois CoC",338,263,75,178,142,36,59,49,10,2013,35,11,24,23,20,3,NA,NA
"2464","IN","502","Indiana Balance of State CoC",4497,3917,580,1855,1743,112,588,555,33,2013,398,272,126,423,357,66,NA,NA
"2465","IN","503","Indianapolis CoC",1599,1479,120,490,486,4,151,150,1,2013,182,137,45,320,309,11,NA,NA
"2466","KS","502","Wichita/Sedgwick County CoC",538,467,71,178,178,0,49,49,0,2013,91,67,24,56,48,8,NA,NA
"2467","KS","503","Topeka/Shawnee County CoC",439,416,23,170,166,4,45,43,2,2013,83,76,7,65,63,2,NA,NA
"2468","KS","505","Overland Park, Shawnee/Johnson County CoC",213,196,17,188,174,14,58,54,4,2013,4,2,2,0,0,0,NA,NA
"2469","KS","507","Kansas Balance of State CoC",1141,1059,82,496,491,5,182,180,2,2013,129,91,38,231,221,10,NA,NA
"2470","KY","500","Kentucky Balance of State CoC",2392,1792,600,1076,893,183,349,292,57,2013,356,144,212,245,173,72,NA,NA
"2471","KY","501","Louisville-Jefferson County CoC",1445,1382,63,495,495,0,168,168,0,2013,145,116,29,171,167,4,NA,NA
"2472","KY","502","Lexington-Fayette County CoC",1408,1317,91,372,370,2,155,154,1,2013,40,8,32,191,170,21,NA,NA
"2473","LA","500","Lafayette/Acadiana CoC",542,433,109,184,184,0,58,58,0,2013,83,31,52,62,47,15,NA,NA
"2474","LA","502","Shreveport, Bossier/Northwest Louisiana CoC",692,513,179,293,263,30,94,87,7,2013,155,48,107,97,74,23,NA,NA
"2475","LA","503","New Orleans/Jefferson Parish CoC",2337,1298,1039,489,462,27,152,141,11,2013,677,90,587,211,119,92,NA,NA
"2476","LA","505","Monroe/Northeast Louisiana CoC",200,172,28,112,112,0,40,40,0,2013,23,10,13,6,2,4,NA,NA
"2477","LA","506","Slidell/Southeast Louisiana CoC",276,241,35,125,119,6,35,33,2,2013,31,25,6,49,47,2,NA,NA
"2478","LA","507","Alexandria/Central Louisiana CoC",118,87,31,26,24,2,7,6,1,2013,9,3,6,24,22,2,NA,NA
"2479","LA","509","Louisiana Balance of State CoC",1061,907,154,89,86,3,29,28,1,2013,137,38,99,126,72,54,NA,NA
"2480","MA","500","Boston CoC",5881,5688,193,3340,3340,0,1164,1164,0,2013,543,494,49,458,446,12,NA,NA
"2481","MA","502","Lynn CoC",468,453,15,369,364,5,127,126,1,2013,53,43,10,13,11,2,NA,NA
"2482","MA","503","Cape Cod Islands CoC",514,321,193,157,150,7,62,59,3,2013,149,58,91,24,15,9,NA,NA
"2483","MA","504","Springfield/Hampden County CoC",2117,2072,45,1722,1722,0,560,560,0,2013,332,304,28,33,32,1,NA,NA
"2484","MA","505","New Bedford CoC",337,318,19,107,104,3,48,47,1,2013,32,25,7,51,50,1,NA,NA
"2485","MA","506","Worcester City & County CoC",1657,1602,55,1071,1061,10,323,319,4,2013,69,48,21,184,175,9,NA,NA
"2486","MA","507","Pittsfield/Berkshire, Franklin, Hampshire Counties CoC",678,638,40,185,182,3,71,70,1,2013,117,85,32,244,244,0,NA,NA
"2487","MA","508","Lowell CoC",559,534,25,341,341,0,117,117,0,2013,67,47,20,48,48,0,NA,NA
"2488","MA","509","Cambridge CoC",535,466,69,169,169,0,59,59,0,2013,174,120,54,21,16,5,NA,NA
"2489","MA","510","Gloucester, Haverhill, Salem/Essex County CoC",1286,1250,36,1036,1036,0,362,362,0,2013,146,127,19,15,13,2,NA,NA
"2490","MA","511","Quincy, Brockton, Weymouth, Plymouth City and County CoC",1690,1641,49,1232,1232,0,413,413,0,2013,171,153,18,94,94,0,NA,NA
"2491","MA","515","Fall River CoC",235,220,15,122,118,4,41,40,1,2013,37,33,4,2,2,0,NA,NA
"2492","MA","516","Massachusetts Balance of State CoC",2652,2595,57,2228,2228,0,904,904,0,2013,179,143,36,63,56,7,NA,NA
"2493","MA","517","Somerville CoC",169,160,9,74,74,0,26,26,0,2013,36,34,2,1,1,0,NA,NA
"2494","MA","519","Attleboro, Taunton/Bristol County CoC",251,221,30,182,175,7,50,48,2,2013,10,1,9,2,1,1,NA,NA
"2495","MD","500","Cumberland/Allegany County CoC",76,64,12,42,42,0,14,14,0,2013,8,2,6,4,4,0,NA,NA
"2496","MD","501","Baltimore CoC",2638,2343,295,650,610,40,215,201,14,2013,226,137,89,293,272,21,NA,NA
"2497","MD","502","Harford County CoC",166,158,8,100,100,0,35,35,0,2013,38,30,8,5,5,0,NA,NA
"2498","MD","503","Annapolis/Anne Arundel County CoC",400,315,85,142,134,8,41,39,2,2013,63,41,22,27,18,9,NA,NA
"2499","MD","504","Howard County CoC",194,139,55,101,97,4,31,30,1,2013,39,9,30,9,5,4,NA,NA
"2500","MD","505","Baltimore County CoC",919,464,455,350,285,65,146,122,24,2013,261,137,124,81,45,36,NA,NA
"2501","MD","506","Carroll County CoC",134,127,7,52,52,0,17,17,0,2013,27,23,4,7,7,0,NA,NA
"2502","MD","507","Cecil County CoC",234,188,46,61,51,10,20,17,3,2013,38,21,17,83,78,5,NA,NA
"2503","MD","508","Charles, Calvert, St.Mary's Counties CoC",833,338,495,445,169,276,132,56,76,2013,292,144,148,41,27,14,NA,NA
"2504","MD","509","Frederick City & County CoC",275,206,69,104,104,0,38,38,0,2013,58,23,35,13,7,6,NA,NA
"2505","MD","510","Garrett County CoC",7,7,0,0,0,0,0,0,0,2013,0,0,0,1,1,0,NA,NA
"2506","MD","511","Mid-Shore Regional CoC",87,67,20,21,16,5,9,7,2,2013,19,9,10,2,2,0,NA,NA
"2507","MD","512","Hagerstown/Washington County CoC",192,187,5,59,59,0,21,21,0,2013,39,37,2,16,16,0,NA,NA
"2508","MD","513","Wicomico, Somerset, Worcester Counties CoC",360,319,41,121,111,10,38,35,3,2013,51,44,7,33,29,4,NA,NA
"2509","MD","600","Prince George's County CoC",686,500,186,370,370,0,123,123,0,2013,93,44,49,25,20,5,NA,NA
"2510","MD","601","Montgomery County CoC",1004,861,143,366,366,0,117,117,0,2013,228,161,67,33,27,6,NA,NA
"2511","ME","500","Maine Statewide CoC",3016,2954,62,1453,1436,17,494,487,7,2013,176,176,0,164,150,14,NA,NA
"2512","MI","500","Michigan Balance of State CoC",1806,1289,517,868,739,129,267,224,43,2013,95,42,53,87,65,22,NA,NA
"2513","MI","501","Detroit CoC",2789,2507,282,475,471,4,160,159,1,2013,291,183,108,518,507,11,NA,NA
"2514","MI","502","Dearborn, Dearborn Heights, Westland/Wayne County CoC",380,358,22,180,180,0,53,53,0,2013,20,14,6,33,29,4,NA,NA
"2515","MI","503","St. Clair Shores, Warren/Macomb County CoC",504,305,199,74,74,0,18,18,0,2013,70,49,21,16,14,2,NA,NA
"2516","MI","504","Pontiac, Royal Oak/Oakland County CoC",698,610,88,221,221,0,83,83,0,2013,64,49,15,22,21,1,NA,NA
"2517","MI","505","Flint/Genesee County CoC",387,270,117,146,146,0,62,62,0,2013,25,12,13,26,19,7,NA,NA
"2518","MI","506","Grand Rapids, Wyoming/Kent County CoC",732,688,44,460,460,0,149,149,0,2013,117,73,44,49,31,18,NA,NA
"2519","MI","507","Portage, Kalamazoo City & County CoC",642,611,31,315,315,0,96,96,0,2013,48,47,1,23,22,1,NA,NA
"2520","MI","508","Lansing, East Lansing/Ingham County CoC",423,357,66,97,97,0,30,30,0,2013,67,48,19,70,63,7,NA,NA
"2521","MI","509","Washtenaw County CoC",510,344,166,151,134,17,48,43,5,2013,116,59,57,61,51,10,NA,NA
"2522","MI","510","Saginaw City & County CoC",350,343,7,175,175,0,53,53,0,2013,16,15,1,16,15,1,NA,NA
"2523","MI","511","Lenawee County CoC",124,111,13,76,65,11,24,22,2,2013,12,12,0,8,8,0,NA,NA
"2524","MI","512","Grand Traverse, Antrim, Leelanau Counties CoC",328,289,39,132,121,11,50,47,3,2013,40,27,13,12,11,1,NA,NA
"2525","MI","513","Marquette, Alger Counties CoC",74,69,5,16,14,2,6,5,1,2013,4,4,0,3,3,0,NA,NA
"2526","MI","514","Battle Creek/Calhoun County CoC",236,172,64,69,69,0,20,20,0,2013,22,10,12,77,34,43,NA,NA
"2527","MI","515","Monroe City & County CoC",139,136,3,28,28,0,7,7,0,2013,2,1,1,32,31,1,NA,NA
"2528","MI","516","Norton Shores, Muskegon City & County CoC",644,236,408,374,92,282,147,36,111,2013,64,4,60,21,6,15,NA,NA
"2529","MI","517","Jackson City & County CoC",187,154,33,95,95,0,38,38,0,2013,13,8,5,15,4,11,NA,NA
"2530","MI","518","Livingston County CoC",127,97,30,66,66,0,20,20,0,2013,10,3,7,1,1,0,NA,NA
"2531","MI","519","Holland/Ottawa County CoC",318,297,21,184,176,8,56,54,2,2013,3,2,1,9,9,0,NA,NA
"2532","MI","523","Eaton County CoC",129,96,33,89,82,7,25,22,3,2013,7,4,3,1,1,0,NA,NA
"2533","MN","500","Minneapolis/Hennepin County CoC",3591,3427,164,1968,1965,3,514,513,1,2013,533,475,58,129,120,9,NA,NA
"2534","MN","501","Saint Paul/Ramsey County CoC",1417,1346,71,739,729,10,251,247,4,2013,288,232,56,54,48,6,NA,NA
"2535","MN","502","Rochester/Southeast Minnesota CoC",452,425,27,306,306,0,101,101,0,2013,73,58,15,3,2,1,NA,NA
"2536","MN","503","Dakota, Anoka, Washington, Scott, Carver Counties",745,635,110,532,499,33,182,172,10,2013,89,48,41,11,8,3,NA,NA
"2537","MN","504","Northeast Minnesota CoC",265,94,171,134,73,61,41,21,20,2013,40,2,38,21,11,10,NA,NA
"2538","MN","505","St. Cloud/Central Minnesota CoC",657,460,197,208,157,51,68,51,17,2013,114,63,51,92,72,20,NA,NA
"2539","MN","506","Northwest Minnesota CoC",253,249,4,145,145,0,42,42,0,2013,36,32,4,6,3,3,NA,NA
"2540","MN","508","Moorhead/West Central Minnesota CoC",287,251,36,155,137,18,43,38,5,2013,62,55,7,17,17,0,NA,NA
"2541","MN","509","Duluth/St.Louis County CoC",410,300,110,205,183,22,70,64,6,2013,103,24,79,15,5,10,NA,NA
"2542","MN","511","Southwest Minnesota CoC",137,112,25,94,82,12,26,24,2,2013,12,12,0,1,0,1,NA,NA
"2543","MO","500","St. Louis County CoC",388,359,29,248,233,15,83,79,4,2013,116,96,20,41,40,1,NA,NA
"2544","MO","501","St.Louis City CoC",1423,1327,96,630,621,9,198,194,4,2013,138,110,28,193,173,20,NA,NA
"2545","MO","503","St. Charles City & County, Lincoln, Warren Counties CoC",940,576,364,553,393,160,186,127,59,2013,78,50,28,3,0,3,NA,NA
"2546","MO","600","Springfield/Greene, Christian, Webster Counties CoC",711,529,182,362,334,28,144,131,13,2013,105,0,105,48,12,36,NA,NA
"2547","MO","602","Joplin/Jasper, Newton Counties CoC",574,539,35,221,221,0,61,61,0,2013,18,6,12,106,99,7,NA,NA
"2548","MO","603","St. Joseph/Andrew, Buchanan, DeKalb Counties CoC",186,177,9,63,63,0,18,18,0,2013,96,88,8,30,28,2,NA,NA
"2549","MO","604a","Kansas City, Independence, Lee’s Summit/Jackson, Wyandotte Counties, MO & KS",2691,1766,925,1205,804,401,357,244,113,2013,327,133,194,316,228,88,NA,NA
"2550","MO","606","Missouri Balance of State CoC",2030,1472,558,828,602,226,265,199,66,2013,208,131,77,168,139,29,NA,NA
"2551","MS","500","Jackson/Rankin, Madison Counties CoC",760,320,440,119,119,0,57,57,0,2013,277,37,240,47,25,22,NA,NA
"2552","MS","501","Mississippi Balance of State CoC",1052,692,360,345,277,68,82,58,24,2013,58,21,37,117,85,32,NA,NA
"2553","MS","503","Gulf Port/Gulf Coast Regional CoC",591,71,520,186,39,147,53,19,34,2013,140,10,130,46,19,27,NA,NA
"2554","MT","500","Montana Statewide CoC",1878,1094,784,667,520,147,207,165,42,2013,227,65,162,309,118,191,NA,NA
"2555","NC","500","Winston-Salem/Forsyth County CoC",394,381,13,101,101,0,33,33,0,2013,82,72,10,23,20,3,NA,NA
"2556","NC","501","Asheville/Buncombe County CoC",570,513,57,92,92,0,33,33,0,2013,54,26,28,232,230,2,NA,NA
"2557","NC","502","Durham City & County CoC",753,700,53,181,181,0,57,57,0,2013,87,58,29,93,87,6,NA,NA
"2558","NC","503","North Carolina Balance of State CoC",3625,2467,1158,1502,1145,357,512,372,140,2013,636,238,398,209,140,69,NA,NA
"2559","NC","504","Greensboro, High Point CoC",949,781,168,298,292,6,94,91,3,2013,148,57,91,78,60,18,NA,NA
"2560","NC","505","Charlotte/Mecklenberg CoC",2418,2135,283,1122,1122,0,356,356,0,2013,158,119,39,120,110,10,NA,NA
"2561","NC","506","Wilmington/Brunswick, New Hanover, Pender Counties CoC",348,245,103,88,82,6,28,26,2,2013,64,12,52,41,30,11,NA,NA
"2562","NC","507","Raleigh/Wake County CoC",1098,1002,96,281,279,2,86,85,1,2013,140,135,5,203,202,1,NA,NA
"2563","NC","509","Gastonia/Cleveland, Gaston, Lincoln Counties CoC",384,274,110,68,68,0,25,25,0,2013,112,40,72,18,15,3,NA,NA
"2564","NC","511","Fayetteville/Cumberland County CoC",631,287,344,288,186,102,96,61,35,2013,293,27,266,77,27,50,NA,NA
"2565","NC","513","Chapel Hill/Orange County CoC",123,93,30,26,26,0,10,10,0,2013,28,12,16,9,7,2,NA,NA
"2566","NC","516","Northwest North Carolina CoC",875,135,740,591,56,535,190,20,170,2013,40,6,34,20,6,14,NA,NA
"2567","ND","500","North Dakota Statewide CoC",2069,674,1395,839,231,608,244,83,161,2013,179,68,111,241,60,181,NA,NA
"2568","NE","500","Nebraska Balance of State CoC",713,660,53,431,417,14,144,140,4,2013,105,93,12,25,20,5,NA,NA
"2569","NE","501","Omaha, Council Bluffs CoC",1476,1459,17,465,465,0,145,145,0,2013,180,163,17,91,89,2,NA,NA
"2570","NE","502","Lincoln CoC",956,853,103,357,357,0,108,108,0,2013,129,86,43,67,52,15,NA,NA
"2571","NH","500","New Hampshire Balance of State CoC",759,647,112,358,335,23,123,115,8,2013,143,65,78,46,37,9,NA,NA
"2572","NH","501","Manchester CoC",382,304,78,154,147,7,56,54,2,2013,84,49,35,17,14,3,NA,NA
"2573","NH","502","Nashua/Hillsborough County CoC",306,294,12,137,137,0,50,50,0,2013,28,21,7,62,61,1,NA,NA
"2574","NJ","500","Atlantic City & County CoC",746,686,60,258,252,6,86,83,3,2013,124,101,23,44,35,9,NA,NA
"2575","NJ","501","Bergen County CoC",346,328,18,137,133,4,50,48,2,2013,33,23,10,17,17,0,NA,NA
"2576","NJ","502","Burlington County CoC",671,629,42,371,363,8,125,121,4,2013,85,77,8,32,17,15,NA,NA
"2577","NJ","503","Camden City & County/Gloucester, Cape May, Cumberland Counties CoC",1291,1098,193,577,545,32,186,175,11,2013,138,83,55,47,36,11,NA,NA
"2578","NJ","504","Newark/Essex County CoC",1646,1482,164,758,730,28,262,254,8,2013,207,159,48,67,50,17,NA,NA
"2579","NJ","506","Jersey City, Bayonne/Hudson County CoC",942,657,285,318,304,14,121,115,6,2013,145,38,107,46,29,17,NA,NA
"2580","NJ","507","New Brunswick/Middlesex County CoC",1031,788,243,575,515,60,185,166,19,2013,100,43,57,44,23,21,NA,NA
"2581","NJ","508","Monmouth County CoC",918,882,36,554,545,9,202,199,3,2013,68,61,7,16,12,4,NA,NA
"2582","NJ","509","Morris County CoC",346,299,47,145,143,2,57,56,1,2013,48,32,16,11,9,2,NA,NA
"2583","NJ","510","Lakewood Township/Ocean County CoC",682,589,93,313,309,4,100,98,2,2013,90,63,27,16,8,8,NA,NA
"2584","NJ","511","Paterson/Passaic County CoC",440,386,54,240,230,10,81,77,4,2013,42,37,5,9,8,1,NA,NA
"2585","NJ","512","Salem County CoC",44,40,4,23,23,0,9,9,0,2013,0,0,0,2,1,1,NA,NA
"2586","NJ","513","Somerset County CoC",312,304,8,115,110,5,42,40,2,2013,39,39,0,99,99,0,NA,NA
"2587","NJ","514","Trenton/Mercer County CoC",668,601,67,288,267,21,78,72,6,2013,58,46,12,37,26,11,NA,NA
"2588","NJ","515","Elizabeth/Union County CoC",1648,1601,47,1122,1111,11,371,368,3,2013,27,21,6,14,13,1,NA,NA
"2589","NJ","516","Warren, Sussex, Hunterdon Counties CoC",271,233,38,115,107,8,39,36,3,2013,33,24,9,39,37,2,NA,NA
"2590","NM","500","Albuquerque CoC",1171,1027,144,354,352,2,122,121,1,2013,233,166,67,170,145,25,NA,NA
"2591","NM","501","New Mexico Balance of State CoC",1648,1364,284,679,628,51,201,183,18,2013,292,140,152,73,38,35,NA,NA
"2592","NV","500","Las Vegas/Clark County CoC",5952,2920,3032,603,589,14,219,214,5,2013,529,219,310,706,406,300,NA,NA
"2593","NV","501","Reno, Sparks/Washoe County CoC",746,657,89,157,152,5,75,73,2,2013,150,139,11,73,64,9,NA,NA
"2594","NV","502","Nevada Balance of State CoC",341,121,220,79,58,21,22,17,5,2013,45,19,26,11,7,4,NA,NA
"2595","NY","500","Rochester, Irondequoit, Greece/Monroe County CoC",1007,883,124,566,508,58,169,159,10,2013,91,41,50,48,47,1,NA,NA
"2596","NY","501","Elmira/Steuben, Allegany, Livingston, Chemung, Schuyler Counties CoC",349,307,42,79,56,23,29,23,6,2013,22,10,12,87,79,8,NA,NA
"2597","NY","503","Albany City & County CoC",728,709,19,284,284,0,94,94,0,2013,101,82,19,89,80,9,NA,NA
"2598","NY","504","Cattaragus County CoC",47,45,2,34,34,0,12,12,0,2013,3,3,0,0,0,0,NA,NA
"2599","NY","505","Syracuse, Auburn/Onondaga, Oswego, Cayuga Counties CoC",994,941,53,244,222,22,88,84,4,2013,123,92,31,74,72,2,NA,NA
"2600","NY","506","Fulton, Montgomery, Schoharie Counties CoC",43,40,3,14,14,0,5,5,0,2013,0,0,0,1,0,1,NA,NA
"2601","NY","507","Schenectady City & County CoC",327,302,25,133,133,0,50,50,0,2013,52,34,18,25,17,8,NA,NA
"2602","NY","508","Buffalo, Niagara Falls/Erie, Niagara, Orleans, Genesee, Wyoming Counties CoC",1162,1048,114,358,352,6,112,111,1,2013,148,82,66,109,100,9,NA,NA
"2603","NY","510","Ithaca/Tompkins County CoC",47,39,8,19,19,0,9,9,0,2013,3,2,1,1,0,1,NA,NA
"2604","NY","511","Binghamton, Union Town/Broome, Otsego, Chenango, Delaware, Cortland, Tioga Count",276,264,12,43,43,0,15,15,0,2013,1,1,0,8,8,0,NA,NA
"2605","NY","512","Troy/Rensselaer County CoC",188,142,46,87,87,0,30,30,0,2013,44,17,27,22,18,4,NA,NA
"2606","NY","513","Wayne, Ontario, Seneca, Yates Counties CoC",171,171,0,12,12,0,3,3,0,2013,21,21,0,62,62,0,NA,NA
"2607","NY","514","Jamestown, Dunkirk/Chautauqua County CoC",62,61,1,26,26,0,8,8,0,2013,1,0,1,0,0,0,NA,NA
"2608","NY","516","Clinton County CoC",140,133,7,49,49,0,17,17,0,2013,25,20,5,7,4,3,NA,NA
"2609","NY","518","Utica, Rome/Oneida, Madison Counties CoC",200,183,17,102,102,0,40,40,0,2013,37,31,6,6,5,1,NA,NA
"2610","NY","519","Columbia, Greene Counties CoC",112,108,4,45,45,0,14,14,0,2013,2,2,0,1,1,0,NA,NA
"2611","NY","520","Franklin, Essex Counties CoC",34,31,3,4,4,0,1,1,0,2013,9,7,2,6,4,2,NA,NA
"2612","NY","522","Jefferson, Lewis, St. Lawrence Counties CoC",83,75,8,11,11,0,4,4,0,2013,28,25,3,21,17,4,NA,NA
"2613","NY","523","Glens Falls, Saratoga Springs/Saratoga, Washington, Warren, Hamilton Counties Co",262,224,38,82,79,3,33,32,1,2013,24,15,9,55,42,13,NA,NA
"2614","NY","600","New York City CoC",64060,60880,3180,39601,39601,0,11516,11516,0,2013,4328,2298,2030,3547,3211,336,NA,NA
"2615","NY","601","Poughkeepsie/Dutchess County CoC",397,384,13,212,212,0,78,78,0,2013,25,16,9,7,6,1,NA,NA
"2616","NY","602","Newburgh, Middletown/Orange County CoC",459,280,179,131,131,0,43,43,0,2013,134,50,84,14,6,8,NA,NA
"2617","NY","603","Nassau, Suffolk Counties CoC",3123,3006,117,2107,2107,0,656,656,0,2013,466,453,13,286,244,42,NA,NA
"2618","NY","604","Yonkers, Mount Vernon/Westchester County CoC",2054,2032,22,1346,1344,2,439,438,1,2013,437,424,13,173,169,4,NA,NA
"2619","NY","606","Rockland County CoC",107,104,3,52,52,0,19,19,0,2013,3,0,3,1,1,0,NA,NA
"2620","NY","607","Sullivan County CoC",556,549,7,341,341,0,123,123,0,2013,108,108,0,4,4,0,NA,NA
"2621","NY","608","Kingston/Ulster County CoC",442,332,110,213,191,22,68,63,5,2013,81,51,30,5,4,1,NA,NA
"2622","OH","500","Cincinnati/Hamilton County CoC",1326,1300,26,501,501,0,148,148,0,2013,274,262,12,175,171,4,NA,NA
"2623","OH","501","Toledo/Lucas County CoC",900,865,35,332,332,0,107,107,0,2013,149,135,14,54,52,2,NA,NA
"2624","OH","502","Cleveland/Cuyahoga County CoC",2129,2052,77,599,599,0,195,195,0,2013,303,266,37,313,299,14,NA,NA
"2625","OH","503","Columbus/Franklin County CoC",1488,1244,244,397,384,13,123,119,4,2013,309,132,177,148,122,26,NA,NA
"2626","OH","504","Youngstown/Mahoning County CoC",227,225,2,129,129,0,38,38,0,2013,42,41,1,15,15,0,NA,NA
"2627","OH","505","Dayton, Kettering/Montgomery County CoC",1041,985,56,422,422,0,133,133,0,2013,64,47,17,131,128,3,NA,NA
"2628","OH","506","Akron, Barberton/Summit County CoC",862,685,177,297,278,19,94,88,6,2013,211,105,106,97,35,62,NA,NA
"2629","OH","507","Ohio Balance of State CoC",3830,3165,665,1807,1648,159,571,531,40,2013,330,172,158,227,184,43,NA,NA
"2630","OH","508","Canton, Massillon, Alliance/Stark County CoC",522,466,56,230,222,8,92,89,3,2013,71,47,24,52,44,8,NA,NA
"2631","OK","500","North Central Oklahoma CoC",190,145,45,103,84,19,36,29,7,2013,35,28,7,14,13,1,NA,NA
"2632","OK","501","Tulsa City & County CoC",1008,886,122,173,157,16,58,52,6,2013,114,80,34,149,136,13,NA,NA
"2633","OK","502","Oklahoma City CoC",1362,1069,293,239,237,2,87,86,1,2013,313,97,216,188,140,48,NA,NA
"2634","OK","503","Oklahoma Balance of State CoC",272,149,123,117,56,61,48,22,26,2013,39,13,26,9,6,3,NA,NA
"2635","OK","504","Norman/Cleveland County CoC",368,213,155,125,100,25,38,29,9,2013,44,25,19,9,3,6,NA,NA
"2636","OK","505","Northeast Oklahoma CoC",487,318,169,183,118,65,60,38,22,2013,112,67,45,26,22,4,NA,NA
"2637","OK","506","Southwest Oklahoma Regional CoC",196,159,37,85,69,16,27,20,7,2013,8,4,4,30,10,20,NA,NA
"2638","OK","507","Southeastern Oklahoma Regional CoC",525,323,202,204,121,83,72,37,35,2013,54,16,38,12,8,4,NA,NA
"2639","OR","500","Eugene, Springfield/Lane County CoC",1751,649,1102,347,267,80,108,83,25,2013,415,140,275,229,78,151,NA,NA
"2640","OR","501","Portland, Gresham/Multnomah County CoC",4441,2546,1895,1258,1135,123,398,361,37,2013,1150,158,992,413,198,215,NA,NA
"2641","OR","502","Medford, Ashland/Jackson County CoC",548,436,112,76,73,3,24,23,1,2013,172,115,57,226,198,28,NA,NA
"2642","OR","503","Central Oregon CoC",506,261,245,190,111,79,60,35,25,2013,137,19,118,40,18,22,NA,NA
"2643","OR","505","Oregon Balance of State CoC",5525,2199,3326,2547,1040,1507,834,333,501,2013,901,279,622,459,153,306,NA,NA
"2644","OR","506","Hillsboro, Beaverton/Washington County CoC",432,200,232,129,85,44,47,30,17,2013,77,8,69,91,64,27,NA,NA
"2645","OR","507","Clackamas County CoC",619,141,478,281,119,162,53,40,13,2013,191,4,187,36,0,36,NA,NA
"2646","PA","500","Philadelphia CoC",5645,5119,526,2575,2575,0,911,911,0,2013,633,220,413,440,369,71,NA,NA
"2647","PA","501","Harrisburg/Dauphin County CoC",390,342,48,176,161,15,59,56,3,2013,76,50,26,37,32,5,NA,NA
"2648","PA","502","Upper Darby, Chester, Haverford/Delaware County CoC",546,501,45,295,295,0,86,86,0,2013,38,26,12,27,21,6,NA,NA
"2649","PA","503","Wilkes-Barre, Hazleton/Luzerne County CoC",165,153,12,59,59,0,22,22,0,2013,3,2,1,21,20,1,NA,NA
"2650","PA","504","Lower Merion, Norristown, Abington/Montgomery County CoC",464,451,13,280,280,0,85,85,0,2013,18,15,3,13,12,1,NA,NA
"2651","PA","505","Chester County CoC",641,598,43,143,143,0,45,45,0,2013,72,63,9,259,259,0,NA,NA
"2652","PA","506","Reading/Berks County CoC",468,455,13,192,192,0,61,61,0,2013,88,75,13,32,29,3,NA,NA
"2653","PA","508","Scranton/Lackawanna County CoC",252,247,5,160,160,0,50,50,0,2013,22,17,5,33,33,0,NA,NA
"2654","PA","509","Eastern Pennsylvania CoC",2081,1764,317,1107,1046,61,363,343,20,2013,202,92,110,136,83,53,NA,NA
"2655","PA","510","Lancaster City & County CoC",518,508,10,259,259,0,94,94,0,2013,34,32,2,36,33,3,NA,NA
"2656","PA","511","Bristol, Bensalem/Bucks County CoC",451,410,41,315,315,0,102,102,0,2013,13,8,5,16,12,4,NA,NA
"2657","PA","512","York City & County CoC",278,248,30,153,133,20,53,47,6,2013,35,25,10,17,14,3,NA,NA
"2658","PA","600","Pittsburgh, McKeesport, Penn Hills/Allegheny County CoC",1492,1401,91,665,665,0,230,230,0,2013,214,181,33,207,191,16,NA,NA
"2659","PA","601","Western Pennsylvania CoC",1170,1060,110,516,485,31,171,162,9,2013,176,158,18,161,157,4,NA,NA
"2660","PA","603","Beaver County CoC",90,87,3,41,41,0,15,15,0,2013,15,14,1,2,1,1,NA,NA
"2661","PA","605","Erie City & County CoC",435,383,52,177,151,26,62,52,10,2013,42,32,10,25,24,1,NA,NA
"2662","RI","500","Rhode Island Statewide CoC",1384,1267,117,522,514,8,177,175,2,2013,251,198,53,97,95,2,NA,NA
"2663","SC","500","Charleston/Low Country CoC",733,332,401,98,98,0,21,21,0,2013,105,39,66,177,116,61,NA,NA
"2664","SC","501","Greenville, Anderson, Spartanburg/Upstate CoC",2308,1600,708,820,589,231,301,201,100,2013,106,23,83,107,57,50,NA,NA
"2665","SC","502","Columbia/Midlands CoC",2007,1073,934,449,317,132,169,115,54,2013,179,70,109,243,142,101,NA,NA
"2666","SC","503","Myrtle Beach, Sumter City & County CoC",1496,406,1090,441,68,373,149,28,121,2013,93,11,82,109,30,79,NA,NA
"2667","SD","500","South Dakota Statewide CoC",1094,755,339,537,361,176,154,115,39,2013,217,71,146,125,106,19,NA,NA
"2668","TN","500","Chattanooga/Southeast Tennessee CoC",591,422,169,202,132,70,66,46,20,2013,102,70,32,50,37,13,NA,NA
"2669","TN","501","Memphis/Shelby County CoC",1816,1660,156,665,665,0,216,216,0,2013,177,82,95,218,197,21,NA,NA
"2670","TN","502","Knoxville/Knox County CoC",993,850,143,96,88,8,35,33,2,2013,167,99,68,99,85,14,NA,NA
"2671","TN","503","Central Tennessee CoC",283,270,13,38,36,2,15,14,1,2013,32,24,8,45,43,2,NA,NA
"2672","TN","504","Nashville-Davidson County CoC",2069,1819,250,263,263,0,90,90,0,2013,943,693,250,305,250,55,NA,NA
"2673","TN","506","Upper Cumberland CoC",372,148,224,165,62,103,51,21,30,2013,74,18,56,11,3,8,NA,NA
"2674","TN","507","Jackson/West Tennessee CoC",1673,270,1403,652,155,497,227,57,170,2013,264,42,222,105,35,70,NA,NA
"2675","TN","509","Appalachian Regional CoC",694,417,277,207,100,107,86,49,37,2013,216,49,167,101,63,38,NA,NA
"2676","TN","510","Murfreesboro/Rutherford County CoC",241,161,80,64,61,3,20,19,1,2013,71,25,46,20,11,9,NA,NA
"2677","TN","512","Morristown/Blount, Sevier, Campbell, Cocke Counties CoC",796,304,492,267,127,140,74,36,38,2013,173,60,113,37,4,33,NA,NA
"2678","TX","500","San Antonio/Bexar County CoC",2980,1737,1243,815,815,0,338,338,0,2013,621,463,158,122,88,34,NA,NA
"2679","TX","503","Austin/Travis County CoC",2090,1325,765,616,616,0,195,195,0,2013,458,130,328,300,125,175,NA,NA
"2680","TX","600","Dallas City & County, Irving CoC",3163,2912,251,1201,1192,9,390,387,3,2013,502,413,89,303,263,40,NA,NA
"2681","TX","601","Fort Worth, Arlington/Tarrant County CoC",2390,2109,281,1108,1108,0,336,336,0,2013,226,159,67,217,166,51,NA,NA
"2682","TX","603","El Paso City & County CoC",1217,1036,181,500,491,9,149,146,3,2013,131,93,38,136,80,56,NA,NA
"2683","TX","604","Waco/McLennan County CoC",295,230,65,177,161,16,71,67,4,2013,30,11,19,32,17,15,NA,NA
"2684","TX","607","Texas Balance of State CoC",10128,3938,6190,2609,1760,849,730,497,233,2013,2022,456,1566,1766,701,1065,NA,NA
"2685","TX","611","Amarillo CoC",516,468,48,125,125,0,40,40,0,2013,122,105,17,106,96,10,NA,NA
"2686","TX","624","Wichita Falls/Wise, Palo Pinto, Wichita, Archer Counties CoC",302,253,49,67,67,0,28,28,0,2013,86,56,30,9,9,0,NA,NA
"2687","TX","700","Houston, Pasadena, Conroe/Harris, Ft. Bend, Montgomery, Counties CoC",6359,3381,2978,1565,1456,109,524,481,43,2013,1309,258,1051,877,452,425,NA,NA
"2688","TX","701","Bryan, College Station/Brazos Valley CoC",175,136,39,74,53,21,25,17,8,2013,28,24,4,10,10,0,NA,NA
"2689","UT","500","Salt Lake City & County CoC",2133,2034,99,792,789,3,244,243,1,2013,313,273,40,247,241,6,NA,NA
"2690","UT","503","Utah Balance of State CoC",891,700,191,432,410,22,135,127,8,2013,119,69,50,69,42,27,NA,NA
"2691","UT","504","Provo/Mountainland CoC",253,125,128,94,67,27,27,21,6,2013,22,7,15,11,7,4,NA,NA
"2692","VA","500","Richmond/Henrico, Chesterfield, Hanover Counties CoC",881,825,56,177,175,2,56,55,1,2013,58,48,10,109,101,8,NA,NA
"2693","VA","501","Norfolk/Chesapeake, Suffolk, Isle of Wight, Southampton Counties CoC",742,697,45,245,241,4,74,72,2,2013,76,54,22,66,57,9,NA,NA
"2694","VA","502","Roanoke City & County, Salem CoC",442,425,17,127,127,0,41,41,0,2013,91,85,6,70,69,1,NA,NA
"2695","VA","503","Virginia Beach CoC",456,389,67,200,200,0,63,63,0,2013,93,63,30,78,69,9,NA,NA
"2696","VA","504","Charlottesville CoC",195,167,28,42,42,0,13,13,0,2013,65,48,17,16,10,6,NA,NA
"2697","VA","505","Newport News, Hampton/Virginia Peninsula CoC",533,494,39,163,161,2,50,49,1,2013,112,94,18,151,147,4,NA,NA
"2698","VA","507","Portsmouth CoC",247,158,89,94,87,7,31,29,2,2013,16,8,8,17,12,5,NA,NA
"2699","VA","508","Lynchburg CoC",150,144,6,74,74,0,22,22,0,2013,9,7,2,7,5,2,NA,NA
"2700","VA","513","Harrisburg, Winchester/Western Virginia CoC",355,286,69,112,98,14,36,33,3,2013,122,89,33,31,24,7,NA,NA
"2701","VA","514","Fredericksburg/Spotsylvania, Stafford Counties CoC",192,164,28,70,70,0,24,24,0,2013,56,37,19,21,16,5,NA,NA
"2702","VA","521","Virginia Balance of State CoC",715,574,141,393,354,39,138,126,12,2013,83,36,47,36,28,8,NA,NA
"2703","VA","600","Arlington County CoC",479,333,146,211,211,0,70,70,0,2013,157,64,93,14,7,7,NA,NA
"2704","VA","601","Fairfax County CoC",1350,1246,104,747,747,0,230,230,0,2013,253,169,84,57,53,4,NA,NA
"2705","VA","602","Loudoun County CoC",166,125,41,85,82,3,24,23,1,2013,28,12,16,9,3,6,NA,NA
"2706","VA","603","Alexandria CoC",275,246,29,90,90,0,33,33,0,2013,74,53,21,11,9,2,NA,NA
"2707","VA","604","Prince William County CoC",447,330,117,263,257,6,79,76,3,2013,63,8,55,26,15,11,NA,NA
"2708","VT","500","Vermont Balance of State CoC",971,866,105,552,526,26,198,190,8,2013,104,85,19,98,88,10,NA,NA
"2709","VT","501","Burlington/Chittenden County CoC",483,404,79,201,197,4,64,63,1,2013,113,55,58,30,23,7,NA,NA
"2710","WA","500","Seattle/King County CoC",9106,6370,2736,3120,3120,0,894,894,0,2013,869,502,367,682,589,93,NA,NA
"2711","WA","501","Washington Balance of State CoC",4671,3068,1603,2153,1752,401,721,607,114,2013,774,279,495,303,207,96,NA,NA
"2712","WA","502","Spokane City & County CoC",1030,970,60,428,423,5,152,150,2,2013,103,91,12,132,125,7,NA,NA
"2713","WA","503","Tacoma, Lakewood/Pierce County CoC",1303,1183,120,764,761,3,228,227,1,2013,151,82,69,93,84,9,NA,NA
"2714","WA","504","Everett/Snohomish County CoC",947,603,344,327,302,25,110,102,8,2013,210,75,135,64,33,31,NA,NA
"2715","WA","508","Vancouver/Clark County CoC",703,513,190,351,317,34,112,101,11,2013,89,47,42,44,20,24,NA,NA
"2716","WI","500","Wisconsin Balance of State CoC",3610,3439,171,2063,2011,52,685,668,17,2013,258,207,51,247,239,8,NA,NA
"2717","WI","501","Milwaukee City & County CoC",1442,1353,89,575,570,5,190,188,2,2013,106,76,30,209,198,11,NA,NA
"2718","WI","502","Racine City & County CoC",221,212,9,94,94,0,31,31,0,2013,11,9,2,38,36,2,NA,NA
"2719","WI","503","Madison/Dane County CoC",831,732,99,367,358,9,110,107,3,2013,146,91,55,58,55,3,NA,NA
"2720","WV","500","Wheeling, Weirton Area CoC",89,87,2,31,31,0,8,8,0,2013,28,27,1,10,10,0,NA,NA
"2721","WV","501","Huntington/Cabell, Wayne Counties CoC",227,212,15,96,96,0,32,32,0,2013,46,35,11,17,13,4,NA,NA
"2722","WV","503","Charleston/Kanawha, Putnam, Boone, Clay Counties CoC",411,355,56,90,90,0,29,29,0,2013,41,39,2,45,39,6,NA,NA
"2723","WV","508","West Virginia Balance of State CoC",1513,958,555,479,357,122,159,123,36,2013,317,149,168,257,230,27,NA,NA
"2724","WY","500","Wyoming Statewide CoC",953,501,452,276,195,81,84,55,29,2013,244,116,128,137,110,27,NA,NA
"2725",NA,NA,"Total",590364,394698,195666,222190,191571,30619,70957,60855,10102,2013,102828,37568,65260,55619,34909,20710,NA,NA
"2726","AK","500","Anchorage CoC",1023,970,53,287,282,5,102,100,2,2014,101,59,42,138,120,18,NA,NA
"2727","AK","501","Alaska Balance of State CoC",761,669,92,288,248,40,91,79,12,2014,105,78,27,40,40,0,NA,NA
"2728","AL","500","Birmingham/Jefferson, St. Clair, Shelby Counties CoC",1329,915,414,414,343,71,139,111,28,2014,331,96,235,174,154,20,NA,NA
"2729","AL","501","Mobile City & County/Baldwin County CoC",598,461,137,201,189,12,64,60,4,2014,75,39,36,61,38,23,NA,NA
"2730","AL","502","Florence/Northwest Alabama CoC",209,189,20,77,70,7,23,22,1,2014,13,3,10,7,5,2,NA,NA
"2731","AL","503","Huntsville/North Alabama CoC",536,499,37,150,150,0,45,45,0,2014,107,84,23,64,58,6,NA,NA
"2732","AL","504","Montgomery City & County CoC",490,409,81,125,114,11,44,41,3,2014,37,12,25,39,25,14,NA,NA
"2733","AL","505","Gadsden/Northeast Alabama CoC",438,368,70,79,53,26,38,25,13,2014,36,16,20,34,29,5,NA,NA
"2734","AL","506","Tuscaloosa City & County CoC",245,133,112,78,30,48,20,8,12,2014,80,2,78,90,75,15,NA,NA
"2735","AL","507","Alabama Balance of State CoC",716,544,172,322,196,126,84,45,39,2014,50,31,19,73,66,7,NA,NA
"2736","AR","500","Little Rock/Central Arkansas CoC",1074,571,503,123,123,0,48,48,0,2014,350,46,304,197,141,56,NA,NA
"2737","AR","501","Fayetteville/Northwest Arkansas CoC",551,329,222,163,118,45,55,40,15,2014,39,1,38,98,41,57,NA,NA
"2738","AR","503","Arkansas  Balance of State  CoC",1056,420,636,294,139,155,120,67,53,2014,50,11,39,35,17,18,NA,NA
"2739","AR","505","Southeast Arkansas CoC",70,70,0,31,31,0,10,10,0,2014,0,0,0,1,1,0,NA,NA
"2740","AR","508","Fort Smith CoC",185,113,72,22,22,0,7,7,0,2014,80,27,53,30,20,10,NA,NA
"2741","AR","512","Boone, Baxter, Marion, Newton Counties CoC",NA,NA,NA,NA,NA,NA,NA,NA,NA,2014,NA,NA,NA,NA,NA,NA,NA,NA
"2742","AZ","500","Arizona Balance of State CoC",2398,1349,1049,719,543,176,233,182,51,2014,266,105,161,263,138,125,NA,NA
"2743","AZ","501","Tucson/Pima County CoC",2179,1712,467,704,663,41,214,206,8,2014,290,126,164,285,235,50,NA,NA
"2744","AZ","502","Phoenix, Mesa/Maricopa County CoC",5918,4865,1053,2878,2869,9,848,846,2,2014,403,85,318,310,262,48,NA,NA
"2745","CA","500","San Jose/Santa Clara City & County CoC",7567,1893,5674,886,830,56,268,251,17,2014,2535,276,2259,813,234,579,NA,NA
"2746","CA","501","San Francisco CoC",6408,2093,4315,632,599,33,244,233,11,2014,2321,811,1510,720,298,422,NA,NA
"2747","CA","502","Oakland, Berkeley/Alameda County CoC",4272,1935,2337,1110,892,218,348,306,42,2014,1094,240,854,538,185,353,NA,NA
"2748","CA","503","Sacramento City & County CoC",2449,1663,786,766,761,5,248,247,1,2014,422,137,285,277,141,136,NA,NA
"2749","CA","504","Santa Rosa, Petaluma/Sonoma County CoC",4266,957,3309,450,396,54,119,103,16,2014,1260,226,1034,421,78,343,NA,NA
"2750","CA","505","Richmond/Contra Costa County CoC",2009,680,1329,349,349,0,111,111,0,2014,775,181,594,176,41,135,NA,NA
"2751","CA","506","Salinas/Monterey, San Benito Counties CoC",2962,756,2206,676,395,281,275,149,126,2014,1089,229,860,238,77,161,NA,NA
"2752","CA","507","Marin County CoC",679,501,178,219,219,0,66,66,0,2014,62,18,44,52,34,18,NA,NA
"2753","CA","508","Watsonville/Santa Cruz City & County CoC",3529,634,2895,533,332,201,155,94,61,2014,981,66,915,393,50,343,NA,NA
"2754","CA","509","Mendocino County CoC",1404,186,1218,148,68,80,43,25,18,2014,221,23,198,46,6,40,NA,NA
"2755","CA","510","Turlock, Modesto/Stanislaus County CoC",1156,713,443,332,226,106,114,76,38,2014,146,83,63,69,41,28,NA,NA
"2756","CA","511","Stockton/San Joaquin County CoC",1588,1325,263,875,850,25,258,250,8,2014,116,49,67,87,65,22,NA,NA
"2757","CA","512","Daly/San Mateo County CoC",2024,725,1299,661,417,244,192,127,65,2014,897,40,857,225,94,131,NA,NA
"2758","CA","513","Visalia/Kings, Tulare Counties CoC",763,386,377,154,129,25,51,42,9,2014,235,28,207,36,9,27,NA,NA
"2759","CA","514","Fresno City & County/Madera County CoC",2592,709,1883,389,379,10,119,114,5,2014,497,22,475,272,85,187,NA,NA
"2760","CA","515","Roseville, Rocklin/Placer, Nevada Counties CoC",762,239,523,143,98,45,48,32,16,2014,240,57,183,73,13,60,NA,NA
"2761","CA","516","Redding/Shasta, Siskiyou, Lassen, Plumas, Del Norte, Modoc, Sierra Counties CoC",630,548,82,169,164,5,63,61,2,2014,125,67,58,62,60,2,NA,NA
"2762","CA","517","Napa City & County CoC",285,194,91,80,80,0,29,29,0,2014,73,31,42,23,9,14,NA,NA
"2763","CA","518","Vallejo/Solano County CoC",1295,406,889,210,158,52,65,44,21,2014,350,45,305,80,47,33,NA,NA
"2764","CA","519","Chico, Paradise/Butte County CoC",696,273,423,110,100,10,35,31,4,2014,313,49,264,95,40,55,NA,NA
"2765","CA","520","Merced City & County CoC",768,159,609,33,29,4,12,11,1,2014,364,13,351,84,11,73,NA,NA
"2766","CA","521","Davis, Woodland/Yolo County CoC",442,244,198,125,125,0,38,38,0,2014,131,34,97,31,11,20,NA,NA
"2767","CA","522","Humboldt County CoC",932,248,684,339,158,181,78,40,38,2014,260,10,250,123,43,80,NA,NA
"2768","CA","523","Colusa, Glenn, Trinity Counties CoC",567,143,424,157,69,88,49,23,26,2014,265,47,218,49,7,42,NA,NA
"2769","CA","524","Yuba City & County/Sutter County CoC",726,347,379,378,209,169,107,35,72,2014,53,0,53,75,67,8,NA,NA
"2770","CA","525","El Dorado County CoC",195,146,49,14,10,4,7,5,2,2014,73,35,38,3,2,1,NA,NA
"2771","CA","526","Amador, Calaveras, Mariposa, Tuolumne Counties CoC",382,142,240,113,98,15,34,30,4,2014,114,4,110,46,18,28,NA,NA
"2772","CA","600","Los Angeles City & County CoC",34393,11803,22590,6229,4158,2071,1580,896,684,2014,8882,1371,7511,3739,1182,2557,NA,NA
"2773","CA","601","San Diego City and County CoC",8506,4521,3985,2007,1698,309,639,547,92,2014,1245,238,1007,1307,790,517,NA,NA
"2774","CA","602","Santa Ana, Anaheim/Orange County CoC",3833,2155,1678,1272,1269,3,410,409,1,2014,814,141,673,398,129,269,NA,NA
"2775","CA","603","Santa Maria/Santa Barbara County CoC",1832,854,978,389,279,110,120,86,34,2014,618,84,534,134,58,76,NA,NA
"2776","CA","604","Bakersfield/Kern County CoC",992,577,415,267,227,40,81,67,14,2014,178,31,147,87,66,21,NA,NA
"2777","CA","606","Long Beach CoC",2738,859,1879,478,221,257,154,73,81,2014,1070,111,959,439,275,164,NA,NA
"2778","CA","607","Pasadena CoC",666,265,401,154,140,14,50,46,4,2014,221,72,149,41,3,38,NA,NA
"2779","CA","608","Riverside City & County CoC",2945,1057,1888,555,411,144,174,129,45,2014,1093,23,1070,296,115,181,NA,NA
"2780","CA","609","San Bernardino City & County CoC",2315,1068,1247,784,654,130,191,155,36,2014,551,69,482,167,35,132,NA,NA
"2781","CA","611","Oxnard, San Buenaventura/Ventura County CoC",1428,518,910,342,162,180,107,46,61,2014,440,19,421,102,14,88,NA,NA
"2782","CA","612","Glendale CoC",292,185,107,88,84,4,31,30,1,2014,79,33,46,19,7,12,NA,NA
"2783","CA","613","Imperial County CoC",298,164,134,117,106,11,36,33,3,2014,127,40,87,7,0,7,NA,NA
"2784","CA","614","San Luis Obispo County CoC",2366,244,2122,454,109,345,207,38,169,2014,748,78,670,253,17,236,NA,NA
"2785","CO","500","Colorado Balance of State CoC",2188,1183,1005,932,644,288,274,191,83,2014,493,79,414,179,86,93,NA,NA
"2786","CO","503","Metropolitan Denver CoC",6621,5950,671,3126,3015,111,932,887,45,2014,801,507,294,429,343,86,NA,NA
"2787","CO","504","Colorado Springs/El Paso County CoC",1219,950,269,397,389,8,111,109,2,2014,327,161,166,145,99,46,NA,NA
"2788","CT","503","Bridgeport, Stamford, Norwalk/Fairfield County CoC",1083,772,311,362,325,37,129,114,15,2014,367,252,115,70,53,17,NA,NA
"2789","CT","505","Connecticut Balance of State CoC",3367,2759,608,1019,963,56,366,344,22,2014,848,595,253,225,168,57,NA,NA
"2790","DE","500","Delaware Statewide CoC",901,864,37,317,310,7,104,102,2,2014,91,82,9,93,89,4,NA,NA
"2791","FL","500","Sarasota, Bradenton/Manatee, Sarasota Counties CoC",1377,780,597,246,220,26,65,56,9,2014,270,76,194,170,95,75,NA,NA
"2792","FL","501","Tampa/Hillsborough County CoC",1944,853,1091,501,302,199,188,95,93,2014,409,30,379,236,110,126,NA,NA
"2793","FL","502","St. Petersburg, Clearwater, Largo/Pinellas County CoC",3391,2213,1178,526,522,4,180,178,2,2014,489,272,217,550,475,75,NA,NA
"2794","FL","503","Lakeland, Winterhaven/Polk County CoC",536,248,288,85,64,21,25,18,7,2014,114,20,94,40,11,29,NA,NA
"2795","FL","504","Daytona Beach, Daytona/Volusia, Flagler Counties CoC",1633,608,1025,462,272,190,165,95,70,2014,198,14,184,135,55,80,NA,NA
"2796","FL","505","Fort Walton Beach/Okaloosa, Walton Counties CoC",1577,302,1275,1021,93,928,393,34,359,2014,436,123,313,211,45,166,NA,NA
"2797","FL","506","Tallahassee/Leon County CoC",805,617,188,126,126,0,38,38,0,2014,220,123,97,108,83,25,NA,NA
"2798","FL","507","Orlando/Orange, Osceola, Seminole Counties CoC",2254,1988,266,864,864,0,245,245,0,2014,125,67,58,299,255,44,NA,NA
"2799","FL","508","Gainesville/Alachua, Putnam Counties CoC",1256,368,888,122,108,14,43,38,5,2014,471,68,403,229,111,118,NA,NA
"2800","FL","509","Fort Pierce/St. Lucie, Indian River, Martin Counties CoC",2591,249,2342,1231,187,1044,431,60,371,2014,131,10,121,118,4,114,NA,NA
"2801","FL","510","Jacksonville-Duval, Clay Counties CoC",2049,1756,293,674,661,13,242,239,3,2014,431,286,145,224,182,42,NA,NA
"2802","FL","511","Pensacola/Escambia, Santa Rosa Counties CoC",843,611,232,122,117,5,33,31,2,2014,184,86,98,100,75,25,NA,NA
"2803","FL","512","St. Johns County CoC",1401,197,1204,339,117,222,109,36,73,2014,65,17,48,48,11,37,NA,NA
"2804","FL","513","Palm Bay, Melbourne/Brevard County CoC",1477,617,860,434,317,117,146,103,43,2014,120,10,110,333,211,122,NA,NA
"2805","FL","514","Ocala/Marion County CoC",918,274,644,354,120,234,121,42,79,2014,95,6,89,71,71,0,NA,NA
"2806","FL","515","Panama City/Bay, Jackson Counties CoC",268,196,72,44,18,26,15,7,8,2014,36,6,30,31,18,13,NA,NA
"2807","FL","517","Hendry, Hardee, Highlands Counties CoC",1346,234,1112,517,163,354,199,81,118,2014,117,34,83,50,0,50,NA,NA
"2808","FL","518","Columbia, Hamilton, Lafayette, Suwannee Counties CoC",1070,83,987,418,42,376,202,18,184,2014,621,0,621,209,25,184,NA,NA
"2809","FL","519","Pasco County CoC",3356,156,3200,1663,53,1610,802,17,785,2014,1204,17,1187,369,36,333,NA,NA
"2810","FL","520","Citrus, Hernando, Lake, Sumter Counties CoC",511,310,201,164,126,38,54,41,13,2014,10,10,0,27,25,2,NA,NA
"2811","FL","600","Miami-Dade County CoC",4156,3316,840,1311,1311,0,385,385,0,2014,732,287,445,317,175,142,NA,NA
"2812","FL","601","Ft Lauderdale/Broward County CoC",2766,1887,879,738,684,54,225,211,14,2014,525,169,356,229,143,86,NA,NA
"2813","FL","602","Punta Gorda/Charlotte County CoC",511,203,308,246,113,133,66,39,27,2014,156,19,137,63,35,28,NA,NA
"2814","FL","603","Ft Myers, Cape Coral/Lee County CoC",871,427,444,171,98,73,40,26,14,2014,281,24,257,120,59,61,NA,NA
"2815","FL","604","Monroe County CoC",678,383,295,84,59,25,28,22,6,2014,116,25,91,92,36,56,NA,NA
"2816","FL","605","West Palm Beach/Palm Beach County CoC",1596,649,947,269,139,130,84,48,36,2014,396,72,324,151,58,93,NA,NA
"2817","FL","606","Naples/Collier County CoC",361,326,35,80,69,11,26,24,2,2014,37,32,5,22,20,2,NA,NA
"2818","GA","500","Atlanta CoC",4797,3422,1375,594,555,39,182,170,12,2014,1341,628,713,477,276,201,NA,NA
"2819","GA","501","Georgia Balance of State CoC",7577,2260,5317,2313,1579,734,725,483,242,2014,1127,160,967,564,126,438,NA,NA
"2820","GA","502","Fulton County CoC",477,374,103,245,237,8,85,83,2,2014,50,9,41,78,55,23,NA,NA
"2821","GA","503","Athens-Clarke County CoC",247,160,87,47,47,0,14,14,0,2014,42,11,31,15,6,9,NA,NA
"2822","GA","504","Augusta-Richmond County CoC",472,326,146,114,88,26,34,29,5,2014,83,35,48,65,49,16,NA,NA
"2823","GA","505","Columbus-Muscogee/Russell County CoC",312,199,113,55,55,0,19,19,0,2014,65,26,39,21,6,15,NA,NA
"2824","GA","506","Marietta/Cobb County CoC",523,379,144,235,213,22,80,75,5,2014,65,21,44,51,17,34,NA,NA
"2825","GA","507","Savannah/Chatham County CoC",1315,574,741,145,145,0,59,59,0,2014,150,55,95,44,37,7,NA,NA
"2826","GA","508","DeKalb County CoC",801,520,281,370,363,7,93,91,2,2014,81,0,81,128,75,53,NA,NA
"2827","HI","500","Hawaii Balance of State CoC",2206,734,1472,812,481,331,212,137,75,2014,567,65,502,208,33,175,NA,NA
"2828","HI","501","Honolulu City and County CoC",4712,3079,1633,2356,2168,188,578,526,52,2014,734,134,600,385,214,171,NA,NA
"2829","IA","500","Sioux City/Dakota, Woodbury Counties CoC",297,268,29,136,136,0,42,42,0,2014,16,10,6,11,11,0,NA,NA
"2830","IA","501","Iowa Balance of State CoC",1939,1874,65,1127,1107,20,348,343,5,2014,112,97,15,100,94,6,NA,NA
"2831","IA","502","Des Moines/Polk County CoC",886,784,102,315,315,0,97,97,0,2014,116,47,69,91,72,19,NA,NA
"2832","ID","500","Boise/Ada County CoC",753,707,46,177,174,3,57,56,1,2014,82,71,11,91,84,7,NA,NA
"2833","ID","501","Idaho Balance of State CoC",1351,761,590,693,446,247,207,141,66,2014,162,34,128,124,51,73,NA,NA
"2834","IL","500","McHenry County CoC",166,161,5,58,58,0,21,21,0,2014,10,9,1,25,25,0,NA,NA
"2835","IL","501","Rockford/Winnebago, Boone Counties CoC",410,379,31,127,120,7,38,36,2,2014,73,60,13,16,16,0,NA,NA
"2836","IL","502","Waukegan, North Chicago/Lake County CoC",409,404,5,203,203,0,67,67,0,2014,31,30,1,70,70,0,NA,NA
"2837","IL","503","Champaign, Urbana, Rantoul/Champaign County CoC",205,193,12,57,57,0,17,17,0,2014,1,1,0,23,21,2,NA,NA
"2838","IL","504","Madison County CoC",240,224,16,167,167,0,46,46,0,2014,53,46,7,8,8,0,NA,NA
"2839","IL","506","Joliet, Bolingbrook/Will County CoC",309,294,15,122,122,0,37,37,0,2014,16,1,15,20,18,2,NA,NA
"2840","IL","507","Peoria, Pekin/Fulton, Tazewell, Peoria, Woodford Counties CoC",405,379,26,163,159,4,56,54,2,2014,53,52,1,10,7,3,NA,NA
"2841","IL","508","East St. Louis, Belleville/St. Clair County CoC",339,201,138,168,137,31,51,42,9,2014,97,8,89,35,29,6,NA,NA
"2842","IL","509","Dekalb City & County CoC",96,90,6,62,62,0,18,18,0,2014,1,0,1,0,0,0,NA,NA
"2843","IL","510","Chicago CoC",6287,5328,959,2549,2545,4,783,781,2,2014,655,421,234,714,458,256,NA,NA
"2844","IL","511","Cook County CoC",1182,1031,151,539,534,5,177,176,1,2014,97,67,30,105,84,21,NA,NA
"2845","IL","512","Bloomington/Central Illinois CoC",669,553,116,450,394,56,194,166,28,2014,59,54,5,52,44,8,NA,NA
"2846","IL","513","Springfield/Sangamon County CoC",269,248,21,94,87,7,32,30,2,2014,52,45,7,25,24,1,NA,NA
"2847","IL","514","DuPage County CoC",654,625,29,354,354,0,119,119,0,2014,73,68,5,19,16,3,NA,NA
"2848","IL","515","South Central Illinois CoC",118,114,4,95,95,0,43,43,0,2014,3,2,1,4,4,0,NA,NA
"2849","IL","516","Decatur/Macon County CoC",256,190,66,105,91,14,28,24,4,2014,65,39,26,17,9,8,NA,NA
"2850","IL","517","Aurora, Elgin/Kane County CoC",405,359,46,95,95,0,31,31,0,2014,95,74,21,34,28,6,NA,NA
"2851","IL","518","Rock Island, Moline/Northwestern Illinois CoC",218,217,1,115,115,0,44,44,0,2014,9,9,0,13,13,0,NA,NA
"2852","IL","519","West Central Illinois CoC",145,140,5,84,84,0,29,29,0,2014,6,6,0,5,5,0,NA,NA
"2853","IL","520","Southern Illinois CoC",325,279,46,150,137,13,49,43,6,2014,39,18,21,39,34,5,NA,NA
"2854","IN","502","Indiana Balance of State CoC",4081,3752,329,1483,1473,10,492,489,3,2014,365,282,83,359,328,31,NA,NA
"2855","IN","503","Indianapolis CoC",1890,1816,74,535,535,0,162,162,0,2014,231,203,28,366,359,7,NA,NA
"2856","KS","502","Wichita/Sedgwick County CoC",631,548,83,189,189,0,59,59,0,2014,107,80,27,62,45,17,NA,NA
"2857","KS","503","Topeka/Shawnee County CoC",416,385,31,184,184,0,52,52,0,2014,75,61,14,66,66,0,NA,NA
"2858","KS","505","Overland Park, Shawnee/Johnson County CoC",167,160,7,143,140,3,45,44,1,2014,6,3,3,1,1,0,NA,NA
"2859","KS","507","Kansas Balance of State CoC",1307,1225,82,615,610,5,204,202,2,2014,79,41,38,213,203,10,NA,NA
"2860","KY","500","Kentucky Balance of State CoC",2229,1559,670,962,680,282,287,220,67,2014,300,160,140,179,167,12,NA,NA
"2861","KY","501","Louisville-Jefferson County CoC",1316,1246,70,338,338,0,118,118,0,2014,208,152,56,218,209,9,NA,NA
"2862","KY","502","Lexington-Fayette County CoC",1544,1453,91,437,435,2,159,158,1,2014,219,187,32,203,182,21,NA,NA
"2863","LA","500","Lafayette/Acadiana CoC",471,441,30,181,181,0,57,57,0,2014,43,35,8,46,40,6,NA,NA
"2864","LA","502","Shreveport, Bossier/Northwest Louisiana CoC",655,529,126,282,282,0,84,84,0,2014,128,56,72,68,54,14,NA,NA
"2865","LA","503","New Orleans/Jefferson Parish CoC",1981,1163,818,286,286,0,91,91,0,2014,472,77,395,193,126,67,NA,NA
"2866","LA","505","Monroe/Northeast Louisiana CoC",220,182,38,118,105,13,45,40,5,2014,26,20,6,18,12,6,NA,NA
"2867","LA","506","Slidell/Southeast Louisiana CoC",262,219,43,98,88,10,30,27,3,2014,33,20,13,43,41,2,NA,NA
"2868","LA","507","Alexandria/Central Louisiana CoC",141,128,13,30,30,0,9,9,0,2014,28,19,9,5,2,3,NA,NA
"2869","LA","509","Louisiana Balance of State CoC",876,841,35,167,167,0,60,60,0,2014,46,35,11,64,57,7,NA,NA
"2870","MA","500","Boston CoC",5987,5807,180,3378,3378,0,1152,1152,0,2014,815,770,45,450,436,14,NA,NA
"2871","MA","502","Lynn CoC",382,372,10,260,260,0,77,77,0,2014,6,2,4,11,10,1,NA,NA
"2872","MA","503","Cape Cod Islands CoC",381,295,86,158,149,9,63,60,3,2014,108,72,36,17,15,2,NA,NA
"2873","MA","504","Springfield/Hampden County CoC",2690,2655,35,2252,2252,0,702,702,0,2014,520,502,18,42,41,1,NA,NA
"2874","MA","505","New Bedford CoC",349,333,16,118,118,0,40,40,0,2014,11,2,9,52,51,1,NA,NA
"2875","MA","506","Worcester City & County CoC",1796,1747,49,1328,1325,3,395,394,1,2014,62,43,19,143,142,1,NA,NA
"2876","MA","507","Pittsfield/Berkshire, Franklin, Hampshire Counties CoC",753,724,29,247,247,0,84,84,0,2014,153,136,17,256,256,0,NA,NA
"2877","MA","508","Lowell CoC",588,553,35,372,372,0,117,117,0,2014,83,71,12,47,45,2,NA,NA
"2878","MA","509","Cambridge CoC",551,504,47,181,181,0,65,65,0,2014,140,109,31,20,17,3,NA,NA
"2879","MA","510","Gloucester, Haverhill, Salem/Essex County CoC",1487,1413,74,1178,1178,0,394,394,0,2014,194,171,23,34,34,0,NA,NA
"2880","MA","511","Quincy, Brockton, Weymouth, Plymouth City and County CoC",1643,1603,40,1239,1239,0,455,455,0,2014,167,149,18,82,82,0,NA,NA
"2881","MA","515","Fall River CoC",354,276,78,141,141,0,48,48,0,2014,66,56,10,9,5,4,NA,NA
"2882","MA","516","Massachusetts Balance of State CoC",3900,3838,62,3370,3370,0,1115,1115,0,2014,943,890,53,83,82,1,NA,NA
"2883","MA","517","Somerville CoC",154,150,4,57,57,0,22,22,0,2014,28,24,4,15,15,0,NA,NA
"2884","MA","519","Attleboro, Taunton/Bristol County CoC",222,208,14,170,170,0,52,52,0,2014,15,9,6,3,3,0,NA,NA
"2885","MD","500","Cumberland/Allegany County CoC",120,105,15,72,68,4,23,22,1,2014,19,15,4,11,10,1,NA,NA
"2886","MD","501","Baltimore CoC",2567,2272,295,590,550,40,206,192,14,2014,491,402,89,305,284,21,NA,NA
"2887","MD","502","Harford County CoC",223,217,6,143,143,0,46,46,0,2014,82,79,3,8,7,1,NA,NA
"2888","MD","503","Annapolis/Anne Arundel County CoC",384,333,51,159,159,0,50,50,0,2014,73,42,31,18,18,0,NA,NA
"2889","MD","504","Howard County CoC",170,148,22,72,72,0,25,25,0,2014,42,33,9,8,6,2,NA,NA
"2890","MD","505","Baltimore County CoC",569,392,177,182,182,0,75,75,0,2014,119,63,56,25,13,12,NA,NA
"2891","MD","506","Carroll County CoC",124,118,6,40,40,0,12,12,0,2014,22,21,1,6,6,0,NA,NA
"2892","MD","507","Cecil County CoC",195,159,36,53,53,0,17,17,0,2014,49,27,22,69,65,4,NA,NA
"2893","MD","508","Charles, Calvert, St.Mary's Counties CoC",1141,551,590,569,245,324,171,75,96,2014,456,206,250,68,33,35,NA,NA
"2894","MD","509","Frederick City & County CoC",246,197,49,105,105,0,36,36,0,2014,90,57,33,10,6,4,NA,NA
"2895","MD","510","Garrett County CoC",13,8,5,6,2,4,2,1,1,2014,0,0,0,1,1,0,NA,NA
"2896","MD","511","Mid-Shore Regional CoC",111,93,18,31,28,3,11,10,1,2014,15,7,8,9,8,1,NA,NA
"2897","MD","512","Hagerstown/Washington County CoC",107,103,4,43,43,0,14,14,0,2014,15,12,3,19,19,0,NA,NA
"2898","MD","513","Wicomico, Somerset, Worcester Counties CoC",336,295,41,85,75,10,29,26,3,2014,30,23,7,36,32,4,NA,NA
"2899","MD","600","Prince George's County CoC",659,480,179,438,342,96,140,111,29,2014,56,19,37,26,19,7,NA,NA
"2900","MD","601","Montgomery County CoC",891,796,95,288,288,0,91,91,0,2014,181,129,52,35,28,7,NA,NA
"2901","ME","500","Maine Statewide CoC",2726,2633,93,1378,1351,27,388,376,12,2014,244,218,26,152,138,14,NA,NA
"2902","MI","500","Michigan Balance of State CoC",2253,1736,517,1175,1046,129,388,345,43,2014,110,57,53,88,66,22,NA,NA
"2903","MI","501","Detroit CoC",2755,2473,282,491,487,4,176,175,1,2014,343,235,108,525,514,11,NA,NA
"2904","MI","502","Dearborn, Dearborn Heights, Westland/Wayne County CoC",456,434,22,265,265,0,74,74,0,2014,23,17,6,38,34,4,NA,NA
"2905","MI","503","St. Clair Shores, Warren/Macomb County CoC",343,301,42,61,61,0,28,28,0,2014,58,53,5,9,9,0,NA,NA
"2906","MI","504","Pontiac, Royal Oak/Oakland County CoC",457,382,75,170,170,0,66,66,0,2014,52,52,0,18,14,4,NA,NA
"2907","MI","505","Flint/Genesee County CoC",635,288,347,163,98,65,54,32,22,2014,105,11,94,45,22,23,NA,NA
"2908","MI","506","Grand Rapids, Wyoming/Kent County CoC",793,760,33,369,369,0,113,113,0,2014,73,55,18,59,55,4,NA,NA
"2909","MI","507","Portage, Kalamazoo City & County CoC",681,671,10,311,311,0,96,96,0,2014,54,52,2,26,26,0,NA,NA
"2910","MI","508","Lansing, East Lansing/Ingham County CoC",429,414,15,135,135,0,43,43,0,2014,62,56,6,54,53,1,NA,NA
"2911","MI","509","Washtenaw County CoC",545,379,166,124,107,17,37,32,5,2014,139,82,57,57,47,10,NA,NA
"2912","MI","510","Saginaw City & County CoC",325,313,12,135,132,3,46,45,1,2014,15,12,3,24,24,0,NA,NA
"2913","MI","511","Lenawee County CoC",138,118,20,95,76,19,26,22,4,2014,6,5,1,8,8,0,NA,NA
"2914","MI","512","Grand Traverse, Antrim, Leelanau Counties CoC",396,341,55,195,195,0,43,43,0,2014,91,68,23,18,16,2,NA,NA
"2915","MI","513","Marquette, Alger Counties CoC",80,75,5,35,33,2,10,9,1,2014,9,9,0,6,6,0,NA,NA
"2916","MI","514","Battle Creek/Calhoun County CoC",284,230,54,75,75,0,23,23,0,2014,33,16,17,60,40,20,NA,NA
"2917","MI","515","Monroe City & County CoC",185,182,3,38,38,0,15,15,0,2014,20,19,1,34,33,1,NA,NA
"2918","MI","516","Norton Shores, Muskegon City & County CoC",584,176,408,320,38,282,123,12,111,2014,63,3,60,23,8,15,NA,NA
"2919","MI","517","Jackson City & County CoC",240,207,33,132,132,0,44,44,0,2014,15,10,5,15,4,11,NA,NA
"2920","MI","518","Livingston County CoC",135,105,30,46,46,0,13,13,0,2014,15,8,7,2,2,0,NA,NA
"2921","MI","519","Holland/Ottawa County CoC",387,379,8,241,241,0,73,73,0,2014,7,5,2,10,10,0,NA,NA
"2922","MI","523","Eaton County CoC",126,111,15,116,104,12,30,27,3,2014,0,0,0,3,3,0,NA,NA
"2923","MN","500","Minneapolis/Hennepin County CoC",3731,3521,210,2088,2082,6,594,593,1,2014,576,425,151,119,106,13,NA,NA
"2924","MN","501","Saint Paul/Ramsey County CoC",1500,1432,68,775,769,6,256,254,2,2014,247,203,44,67,62,5,NA,NA
"2925","MN","502","Rochester/Southeast Minnesota CoC",482,458,24,367,360,7,112,110,2,2014,66,56,10,3,3,0,NA,NA
"2926","MN","503","Dakota, Anoka, Washington, Scott, Carver Counties",735,637,98,473,434,39,141,130,11,2014,81,64,17,18,10,8,NA,NA
"2927","MN","504","Northeast Minnesota CoC",200,66,134,110,54,56,27,13,14,2014,18,0,18,13,5,8,NA,NA
"2928","MN","505","St. Cloud/Central Minnesota CoC",607,500,107,267,256,11,89,86,3,2014,52,18,34,53,45,8,NA,NA
"2929","MN","506","Northwest Minnesota CoC",299,280,19,210,197,13,69,66,3,2014,50,45,5,3,1,2,NA,NA
"2930","MN","508","Moorhead/West Central Minnesota CoC",214,203,11,102,102,0,30,30,0,2014,26,23,3,15,14,1,NA,NA
"2931","MN","509","Duluth/St.Louis County CoC",429,305,124,189,178,11,62,59,3,2014,114,50,64,24,15,9,NA,NA
"2932","MN","511","Southwest Minnesota CoC",180,180,0,144,144,0,42,42,0,2014,5,5,0,2,2,0,NA,NA
"2933","MO","500","St. Louis County CoC",402,347,55,219,174,45,67,59,8,2014,15,10,5,47,43,4,NA,NA
"2934","MO","501","St.Louis City CoC",1354,1258,96,574,565,9,151,147,4,2014,202,174,28,160,140,20,NA,NA
"2935","MO","503","St. Charles City & County, Lincoln, Warren Counties CoC",896,614,282,597,449,148,182,139,43,2014,79,48,31,8,6,2,NA,NA
"2936","MO","600","Springfield/Greene, Christian, Webster Counties CoC",656,572,84,202,202,0,72,72,0,2014,101,17,84,55,40,15,NA,NA
"2937","MO","602","Joplin/Jasper, Newton Counties CoC",315,281,34,142,135,7,42,39,3,2014,35,19,16,43,40,3,NA,NA
"2938","MO","603","St. Joseph/Andrew, Buchanan, DeKalb Counties CoC",200,194,6,85,85,0,29,29,0,2014,54,51,3,17,17,0,NA,NA
"2939","MO","604a","Kansas City, Independence, Lee’s Summit/Jackson, Wyandotte Counties, MO & KS",2193,1918,275,579,555,24,170,163,7,2014,374,263,111,251,206,45,NA,NA
"2940","MO","606","Missouri Balance of State CoC",1528,1341,187,696,609,87,224,199,25,2014,190,159,31,122,112,10,NA,NA
"2941","MS","500","Jackson/Rankin, Madison Counties CoC",846,511,335,157,157,0,53,53,0,2014,176,50,126,144,123,21,NA,NA
"2942","MS","501","Mississippi Balance of State CoC",954,700,254,270,230,40,90,76,14,2014,45,19,26,101,87,14,NA,NA
"2943","MS","503","Gulf Port/Gulf Coast Regional CoC",426,194,232,85,85,0,36,36,0,2014,61,10,51,34,11,23,NA,NA
"2944","MT","500","Montana Statewide CoC",1745,911,834,578,418,160,166,122,44,2014,270,77,193,256,94,162,NA,NA
"2945","NC","500","Winston-Salem/Forsyth County CoC",515,496,19,101,101,0,34,34,0,2014,99,86,13,43,43,0,NA,NA
"2946","NC","501","Asheville/Buncombe County CoC",530,465,65,52,52,0,20,20,0,2014,47,7,40,224,217,7,NA,NA
"2947","NC","502","Durham City & County CoC",811,758,53,176,176,0,55,55,0,2014,111,82,29,136,130,6,NA,NA
"2948","NC","503","North Carolina Balance of State CoC",3195,2508,687,1168,1054,114,383,341,42,2014,415,193,222,183,130,53,NA,NA
"2949","NC","504","Greensboro, High Point CoC",897,798,99,280,280,0,85,85,0,2014,109,43,66,98,91,7,NA,NA
"2950","NC","505","Charlotte/Mecklenberg CoC",2014,1850,164,820,811,9,280,277,3,2014,210,129,81,157,142,15,NA,NA
"2951","NC","506","Wilmington/Brunswick, New Hanover, Pender Counties CoC",321,234,87,59,53,6,21,19,2,2014,64,13,51,48,31,17,NA,NA
"2952","NC","507","Raleigh/Wake County CoC",1170,1046,124,351,327,24,112,104,8,2014,98,84,14,110,101,9,NA,NA
"2953","NC","509","Gastonia/Cleveland, Gaston, Lincoln Counties CoC",423,232,191,112,80,32,40,31,9,2014,94,41,53,69,51,18,NA,NA
"2954","NC","511","Fayetteville/Cumberland County CoC",653,268,385,256,130,126,70,39,31,2014,127,20,107,66,34,32,NA,NA
"2955","NC","513","Chapel Hill/Orange County CoC",108,99,9,26,26,0,9,9,0,2014,23,16,7,13,11,2,NA,NA
"2956","NC","516","Northwest North Carolina CoC",854,120,734,592,46,546,194,18,176,2014,34,6,28,17,1,16,NA,NA
"2957","ND","500","North Dakota Statewide CoC",1258,794,464,372,268,104,120,88,32,2014,115,101,14,151,117,34,NA,NA
"2958","NE","500","Nebraska Balance of State CoC",560,523,37,291,287,4,90,89,1,2014,73,62,11,27,18,9,NA,NA
"2959","NE","501","Omaha, Council Bluffs CoC",1630,1604,26,517,517,0,158,158,0,2014,247,242,5,133,131,2,NA,NA
"2960","NE","502","Lincoln CoC",836,790,46,325,325,0,99,99,0,2014,106,93,13,81,75,6,NA,NA
"2961","NH","500","New Hampshire Balance of State CoC",689,627,62,328,314,14,116,110,6,2014,187,161,26,40,37,3,NA,NA
"2962","NH","501","Manchester CoC",407,348,59,158,158,0,63,63,0,2014,71,52,19,54,49,5,NA,NA
"2963","NH","502","Nashua/Hillsborough County CoC",280,268,12,95,95,0,34,34,0,2014,80,73,7,77,76,1,NA,NA
"2964","NJ","500","Atlantic City & County CoC",544,476,68,50,50,0,19,19,0,2014,141,111,30,41,36,5,NA,NA
"2965","NJ","501","Bergen County CoC",371,338,33,153,151,2,54,53,1,2014,35,25,10,18,16,2,NA,NA
"2966","NJ","502","Burlington County CoC",1020,999,21,500,498,2,148,147,1,2014,157,157,0,18,18,0,NA,NA
"2967","NJ","503","Camden City & County/Gloucester, Cape May, Cumberland Counties CoC",1695,1593,102,723,719,4,245,244,1,2014,158,113,45,138,127,11,NA,NA
"2968","NJ","504","Newark/Essex County CoC",1483,1260,223,560,560,0,199,199,0,2014,174,76,98,54,35,19,NA,NA
"2969","NJ","506","Jersey City, Bayonne/Hudson County CoC",821,655,166,286,284,2,105,104,1,2014,156,60,96,35,20,15,NA,NA
"2970","NJ","507","New Brunswick/Middlesex County CoC",802,700,102,408,404,4,124,123,1,2014,105,80,25,32,23,9,NA,NA
"2971","NJ","508","Monmouth County CoC",588,576,12,379,379,0,126,126,0,2014,80,77,3,12,10,2,NA,NA
"2972","NJ","509","Morris County CoC",389,359,30,126,126,0,44,44,0,2014,57,39,18,14,12,2,NA,NA
"2973","NJ","510","Lakewood Township/Ocean County CoC",627,569,58,293,293,0,97,97,0,2014,120,96,24,6,5,1,NA,NA
"2974","NJ","511","Paterson/Passaic County CoC",376,372,4,189,189,0,65,65,0,2014,17,15,2,6,5,1,NA,NA
"2975","NJ","512","Salem County CoC",42,38,4,21,21,0,5,5,0,2014,1,1,0,2,1,1,NA,NA
"2976","NJ","513","Somerset County CoC",323,310,13,102,98,4,34,33,1,2014,14,13,1,141,139,2,NA,NA
"2977","NJ","514","Trenton/Mercer County CoC",632,594,38,201,196,5,71,70,1,2014,64,48,16,38,34,4,NA,NA
"2978","NJ","515","Elizabeth/Union County CoC",1679,1631,48,1162,1160,2,353,352,1,2014,82,61,21,13,11,2,NA,NA
"2979","NJ","516","Warren, Sussex, Hunterdon Counties CoC",279,266,13,72,72,0,27,27,0,2014,38,35,3,62,62,0,NA,NA
"2980","NM","500","Albuquerque CoC",1254,1110,144,386,384,2,124,123,1,2014,200,133,67,249,224,25,NA,NA
"2981","NM","501","New Mexico Balance of State CoC",1492,1208,284,556,505,51,182,164,18,2014,509,357,152,69,34,35,NA,NA
"2982","NV","500","Las Vegas/Clark County CoC",7443,3949,3494,1091,1091,0,355,355,0,2014,460,38,422,897,433,464,NA,NA
"2983","NV","501","Reno, Sparks/Washoe County CoC",769,672,97,69,69,0,24,24,0,2014,124,55,69,119,104,15,NA,NA
"2984","NV","502","Nevada Balance of State CoC",370,176,194,66,66,0,18,18,0,2014,121,11,110,20,9,11,NA,NA
"2985","NY","500","Rochester, Irondequoit, Greece/Monroe County CoC",838,787,51,344,339,5,132,131,1,2014,31,31,0,51,47,4,NA,NA
"2986","NY","501","Elmira/Steuben, Allegany, Livingston, Chemung, Schuyler Counties CoC",512,365,147,134,113,21,48,40,8,2014,65,20,45,100,35,65,NA,NA
"2987","NY","503","Albany City & County CoC",650,621,29,211,211,0,90,90,0,2014,81,59,22,48,43,5,NA,NA
"2988","NY","504","Cattaragus County CoC",33,31,2,21,21,0,7,7,0,2014,1,1,0,0,0,0,NA,NA
"2989","NY","505","Syracuse, Auburn/Onondaga, Oswego, Cayuga Counties CoC",1024,1008,16,251,251,0,93,93,0,2014,90,84,6,67,66,1,NA,NA
"2990","NY","507","Schenectady City & County CoC",243,219,24,105,105,0,32,32,0,2014,26,14,12,17,16,1,NA,NA
"2991","NY","508","Buffalo, Niagara Falls/Erie, Niagara, Orleans, Genesee, Wyoming Counties CoC",1088,1021,67,396,396,0,128,128,0,2014,98,52,46,108,97,11,NA,NA
"2992","NY","510","Ithaca/Tompkins County CoC",47,35,12,24,24,0,10,10,0,2014,5,1,4,1,1,0,NA,NA
"2993","NY","511","Binghamton, Union Town/Broome, Otsego, Chenango, Delaware, Cortland, Tioga Count",309,270,39,58,43,15,19,15,4,2014,24,15,9,8,8,0,NA,NA
"2994","NY","512","Troy/Rensselaer County CoC",216,164,52,114,114,0,44,44,0,2014,47,18,29,10,6,4,NA,NA
"2995","NY","513","Wayne, Ontario, Seneca, Yates Counties CoC",92,92,0,13,13,0,4,4,0,2014,34,34,0,28,28,0,NA,NA
"2996","NY","514","Jamestown, Dunkirk/Chautauqua County CoC",53,51,2,27,27,0,10,10,0,2014,11,9,2,4,4,0,NA,NA
"2997","NY","516","Clinton County CoC",133,131,2,48,48,0,17,17,0,2014,12,10,2,6,6,0,NA,NA
"2998","NY","518","Utica, Rome/Oneida, Madison Counties CoC",159,142,17,58,58,0,24,24,0,2014,32,26,6,2,1,1,NA,NA
"2999","NY","519","Columbia, Greene Counties CoC",128,127,1,71,71,0,20,20,0,2014,16,15,1,2,1,1,NA,NA
"3000","NY","520","Franklin, Essex Counties CoC",78,73,5,31,29,2,10,9,1,2014,6,3,3,5,2,3,NA,NA
"3001","NY","522","Jefferson, Lewis, St. Lawrence Counties CoC",149,146,3,81,78,3,20,19,1,2014,1,1,0,1,1,0,NA,NA
"3002","NY","523","Glens Falls, Saratoga Springs/Saratoga, Washington, Warren, Hamilton Counties Co",262,255,7,91,91,0,32,32,0,2014,37,37,0,42,40,2,NA,NA
"3003","NY","600","New York City CoC",67810,64453,3357,41633,41633,0,11996,11996,0,2014,5873,3728,2145,1645,1316,329,NA,NA
"3004","NY","601","Poughkeepsie/Dutchess County CoC",403,396,7,196,196,0,71,71,0,2014,9,4,5,6,5,1,NA,NA
"3005","NY","602","Newburgh, Middletown/Orange County CoC",421,299,122,140,140,0,47,47,0,2014,84,38,46,18,7,11,NA,NA
"3006","NY","603","Nassau, Suffolk Counties CoC",3207,3143,64,2288,2288,0,916,916,0,2014,367,355,12,174,167,7,NA,NA
"3007","NY","604","Yonkers, Mount Vernon/Westchester County CoC",2138,2118,20,1334,1334,0,467,467,0,2014,205,193,12,183,180,3,NA,NA
"3008","NY","606","Rockland County CoC",125,106,19,43,43,0,15,15,0,2014,6,0,6,0,0,0,NA,NA
"3009","NY","607","Sullivan County CoC",131,130,1,59,59,0,23,23,0,2014,15,15,0,0,0,0,NA,NA
"3010","NY","608","Kingston/Ulster County CoC",341,304,37,176,162,14,63,59,4,2014,36,20,16,16,8,8,NA,NA
"3011","OH","500","Cincinnati/Hamilton County CoC",1043,1026,17,284,284,0,80,80,0,2014,166,156,10,192,191,1,NA,NA
"3012","OH","501","Toledo/Lucas County CoC",809,800,9,326,326,0,112,112,0,2014,107,103,4,51,48,3,NA,NA
"3013","OH","502","Cleveland/Cuyahoga County CoC",2103,2075,28,530,530,0,155,155,0,2014,252,237,15,329,327,2,NA,NA
"3014","OH","503","Columbus/Franklin County CoC",1614,1381,233,466,466,0,138,138,0,2014,257,82,175,156,133,23,NA,NA
"3015","OH","504","Youngstown/Mahoning County CoC",256,248,8,90,90,0,41,41,0,2014,88,82,6,25,25,0,NA,NA
"3016","OH","505","Dayton, Kettering/Montgomery County CoC",791,757,34,208,208,0,69,69,0,2014,39,27,12,128,128,0,NA,NA
"3017","OH","506","Akron, Barberton/Summit County CoC",870,693,177,291,272,19,93,87,6,2014,219,113,106,120,58,62,NA,NA
"3018","OH","507","Ohio Balance of State CoC",3806,3247,559,1652,1507,145,537,492,45,2014,282,163,119,210,176,34,NA,NA
"3019","OH","508","Canton, Massillon, Alliance/Stark County CoC",531,493,38,272,268,4,89,87,2,2014,71,46,25,25,16,9,NA,NA
"3020","OK","500","North Central Oklahoma CoC",201,154,47,105,87,18,40,33,7,2014,29,24,5,11,7,4,NA,NA
"3021","OK","501","Tulsa City & County CoC",1010,908,102,276,272,4,86,84,2,2014,99,60,39,114,101,13,NA,NA
"3022","OK","502","Oklahoma City CoC",1481,1223,258,215,215,0,71,71,0,2014,249,175,74,178,123,55,NA,NA
"3023","OK","503","Oklahoma Balance of State CoC",295,154,141,158,65,93,62,23,39,2014,40,8,32,2,2,0,NA,NA
"3024","OK","504","Norman/Cleveland County CoC",140,118,22,67,67,0,20,20,0,2014,48,35,13,6,6,0,NA,NA
"3025","OK","505","Northeast Oklahoma CoC",383,300,83,123,95,28,41,32,9,2014,103,81,22,51,21,30,NA,NA
"3026","OK","506","Southwest Oklahoma Regional CoC",239,177,62,81,78,3,27,26,1,2014,30,10,20,25,5,20,NA,NA
"3027","OK","507","Southeastern Oklahoma Regional CoC",442,225,217,202,89,113,53,33,20,2014,73,23,50,21,8,13,NA,NA
"3028","OR","500","Eugene, Springfield/Lane County CoC",1767,665,1102,415,335,80,129,104,25,2014,412,137,275,230,79,151,NA,NA
"3029","OR","501","Portland, Gresham/Multnomah County CoC",3927,2032,1895,812,689,123,266,229,37,2014,1102,110,992,412,197,215,NA,NA
"3030","OR","502","Medford, Ashland/Jackson County CoC",625,399,226,124,47,77,36,15,21,2014,84,20,64,241,202,39,NA,NA
"3031","OR","503","Central Oregon CoC",568,323,245,276,197,79,85,60,25,2014,130,12,118,37,15,22,NA,NA
"3032","OR","505","Oregon Balance of State CoC",4122,2344,1778,2008,949,1059,631,309,322,2014,653,276,377,260,158,102,NA,NA
"3033","OR","506","Hillsboro, Beaverton/Washington County CoC",537,198,339,256,96,160,75,29,46,2014,117,12,105,76,51,25,NA,NA
"3034","OR","507","Clackamas County CoC",618,140,478,285,123,162,53,40,13,2014,197,10,187,36,0,36,NA,NA
"3035","PA","500","Philadelphia CoC",5738,5377,361,2629,2629,0,932,932,0,2014,702,461,241,357,337,20,NA,NA
"3036","PA","501","Harrisburg/Dauphin County CoC",396,357,39,159,159,0,60,60,0,2014,50,36,14,49,45,4,NA,NA
"3037","PA","502","Upper Darby, Chester, Haverford/Delaware County CoC",509,462,47,252,252,0,75,75,0,2014,46,35,11,20,17,3,NA,NA
"3038","PA","503","Wilkes-Barre, Hazleton/Luzerne County CoC",192,180,12,77,77,0,26,26,0,2014,0,0,0,15,14,1,NA,NA
"3039","PA","504","Lower Merion, Norristown, Abington/Montgomery County CoC",438,432,6,243,243,0,73,73,0,2014,28,25,3,6,6,0,NA,NA
"3040","PA","505","Chester County CoC",679,640,39,181,173,8,67,65,2,2014,79,56,23,288,288,0,NA,NA
"3041","PA","506","Reading/Berks County CoC",604,593,11,221,221,0,75,75,0,2014,68,66,2,43,42,1,NA,NA
"3042","PA","508","Scranton/Lackawanna County CoC",287,282,5,170,170,0,52,52,0,2014,23,18,5,36,36,0,NA,NA
"3043","PA","509","Eastern Pennsylvania CoC",2021,1786,235,1066,1034,32,346,337,9,2014,139,60,79,103,81,22,NA,NA
"3044","PA","510","Lancaster City & County CoC",498,492,6,241,241,0,94,94,0,2014,10,6,4,39,39,0,NA,NA
"3045","PA","511","Bristol, Bensalem/Bucks County CoC",492,464,28,308,308,0,107,107,0,2014,27,16,11,12,12,0,NA,NA
"3046","PA","512","York City & County CoC",302,272,30,139,119,20,44,38,6,2014,47,37,10,15,12,3,NA,NA
"3047","PA","600","Pittsburgh, McKeesport, Penn Hills/Allegheny County CoC",1573,1465,108,578,578,0,196,196,0,2014,198,157,41,231,212,19,NA,NA
"3048","PA","601","Western Pennsylvania CoC",1101,1045,56,501,492,9,162,160,2,2014,135,116,19,174,173,1,NA,NA
"3049","PA","603","Beaver County CoC",95,93,2,51,51,0,18,18,0,2014,9,7,2,2,2,0,NA,NA
"3050","PA","605","Erie City & County CoC",408,361,47,158,134,24,57,49,8,2014,46,38,8,21,20,1,NA,NA
"3051","RI","500","Rhode Island Statewide CoC",1190,1170,20,411,409,2,132,131,1,2014,204,198,6,108,108,0,NA,NA
"3052","SC","500","Charleston/Low Country CoC",516,379,137,91,88,3,31,30,1,2014,37,16,21,129,99,30,NA,NA
"3053","SC","501","Greenville, Anderson, Spartanburg/Upstate CoC",1636,1246,390,576,536,40,194,174,20,2014,76,36,40,107,61,46,NA,NA
"3054","SC","502","Columbia/Midlands CoC",1588,1162,426,350,300,50,127,104,23,2014,62,35,27,234,189,45,NA,NA
"3055","SC","503","Myrtle Beach, Sumter City & County CoC",1317,462,855,227,73,154,93,29,64,2014,98,13,85,233,50,183,NA,NA
"3056","SD","500","South Dakota Statewide CoC",885,830,55,395,380,15,121,117,4,2014,118,92,26,132,128,4,NA,NA
"3057","TN","500","Chattanooga/Southeast Tennessee CoC",627,456,171,198,156,42,73,54,19,2014,168,104,64,68,54,14,NA,NA
"3058","TN","501","Memphis/Shelby County CoC",1675,1554,121,531,531,0,151,151,0,2014,149,76,73,281,269,12,NA,NA
"3059","TN","502","Knoxville/Knox County CoC",861,780,81,111,105,6,37,34,3,2014,149,117,32,135,125,10,NA,NA
"3060","TN","503","Central Tennessee CoC",286,240,46,62,58,4,17,16,1,2014,28,20,8,65,61,4,NA,NA
"3061","TN","504","Nashville-Davidson County CoC",2234,2027,207,330,330,0,87,87,0,2014,1006,799,207,285,239,46,NA,NA
"3062","TN","506","Upper Cumberland CoC",342,184,158,88,67,21,33,25,8,2014,31,16,15,31,15,16,NA,NA
"3063","TN","507","Jackson/West Tennessee CoC",1601,205,1396,587,61,526,196,21,175,2014,260,45,215,88,12,76,NA,NA
"3064","TN","509","Appalachian Regional CoC",598,432,166,126,120,6,40,38,2,2014,179,117,62,148,125,23,NA,NA
"3065","TN","510","Murfreesboro/Rutherford County CoC",258,182,76,68,68,0,19,19,0,2014,78,32,46,21,13,8,NA,NA
"3066","TN","512","Morristown/Blount, Sevier, Campbell, Cocke Counties CoC",933,323,610,514,194,320,151,53,98,2014,147,38,109,20,7,13,NA,NA
"3067","TX","500","San Antonio/Bexar County CoC",2892,1970,922,967,956,11,279,275,4,2014,614,411,203,263,219,44,NA,NA
"3068","TX","503","Austin/Travis County CoC",1987,1539,448,700,696,4,212,211,1,2014,384,204,180,176,127,49,NA,NA
"3069","TX","600","Dallas City & County, Irving CoC",3514,3272,242,1653,1641,12,513,509,4,2014,489,390,99,335,293,42,NA,NA
"3070","TX","601","Fort Worth, Arlington/Tarrant County CoC",2425,2241,184,1035,1035,0,321,321,0,2014,331,277,54,252,217,35,NA,NA
"3071","TX","603","El Paso City & County CoC",1260,1079,181,511,502,9,158,155,3,2014,179,141,38,123,67,56,NA,NA
"3072","TX","604","Waco/McLennan County CoC",246,202,44,98,98,0,35,35,0,2014,32,13,19,31,19,12,NA,NA
"3073","TX","607","Texas Balance of State CoC",9943,4063,5880,2662,1860,802,735,515,220,2014,2434,522,1912,823,255,568,NA,NA
"3074","TX","611","Amarillo CoC",451,448,3,155,155,0,48,48,0,2014,86,85,1,55,55,0,NA,NA
"3075","TX","624","Wichita Falls/Wise, Palo Pinto, Wichita, Archer Counties CoC",281,259,22,79,74,5,36,35,1,2014,75,65,10,4,4,0,NA,NA
"3076","TX","700","Houston, Pasadena, Conroe/Harris, Ft. Bend, Montgomery, Counties CoC",5308,3017,2291,1390,1390,0,427,427,0,2014,769,123,646,644,310,334,NA,NA
"3077","TX","701","Bryan, College Station/Brazos Valley CoC",188,138,50,68,63,5,20,18,2,2014,23,0,23,12,10,2,NA,NA
"3078","UT","500","Salt Lake City & County CoC",2150,2040,110,818,813,5,250,249,1,2014,369,342,27,275,260,15,NA,NA
"3079","UT","503","Utah Balance of State CoC",782,614,168,461,347,114,126,110,16,2014,47,33,14,36,31,5,NA,NA
"3080","UT","504","Provo/Mountainland CoC",149,114,35,73,68,5,22,21,1,2014,6,5,1,6,2,4,NA,NA
"3081","VA","500","Richmond/Henrico, Chesterfield, Hanover Counties CoC",846,781,65,172,172,0,63,63,0,2014,74,54,20,137,122,15,NA,NA
"3082","VA","501","Norfolk/Chesapeake, Suffolk, Isle of Wight, Southampton Counties CoC",668,630,38,168,168,0,53,53,0,2014,48,31,17,54,46,8,NA,NA
"3083","VA","502","Roanoke City & County, Salem CoC",440,433,7,119,119,0,42,42,0,2014,62,57,5,63,62,1,NA,NA
"3084","VA","503","Virginia Beach CoC",440,382,58,189,189,0,56,56,0,2014,86,50,36,59,49,10,NA,NA
"3085","VA","504","Charlottesville CoC",204,178,26,63,63,0,20,20,0,2014,32,20,12,12,10,2,NA,NA
"3086","VA","505","Newport News, Hampton/Virginia Peninsula CoC",525,497,28,184,184,0,60,60,0,2014,131,113,18,79,72,7,NA,NA
"3087","VA","507","Portsmouth CoC",160,117,43,52,52,0,17,17,0,2014,13,11,2,16,13,3,NA,NA
"3088","VA","508","Lynchburg CoC",220,217,3,92,92,0,26,26,0,2014,32,32,0,13,13,0,NA,NA
"3089","VA","513","Harrisburg, Winchester/Western Virginia CoC",249,237,12,79,75,4,26,25,1,2014,53,50,3,13,12,1,NA,NA
"3090","VA","514","Fredericksburg/Spotsylvania, Stafford Counties CoC",201,171,30,83,83,0,28,28,0,2014,45,28,17,18,10,8,NA,NA
"3091","VA","521","Virginia Balance of State CoC",662,546,116,335,313,22,109,100,9,2014,31,16,15,38,34,4,NA,NA
"3092","VA","600","Arlington County CoC",291,240,51,113,113,0,35,35,0,2014,74,38,36,21,13,8,NA,NA
"3093","VA","601","Fairfax County CoC",1225,1159,66,695,695,0,211,211,0,2014,198,158,40,51,45,6,NA,NA
"3094","VA","602","Loudoun County CoC",177,151,26,101,101,0,31,31,0,2014,20,10,10,9,7,2,NA,NA
"3095","VA","603","Alexandria CoC",267,244,23,88,88,0,32,32,0,2014,63,45,18,18,16,2,NA,NA
"3096","VA","604","Prince William County CoC",445,347,98,253,253,0,74,74,0,2014,59,17,42,19,11,8,NA,NA
"3097","VT","500","Vermont Balance of State CoC",1027,954,73,518,508,10,166,161,5,2014,132,114,18,89,84,5,NA,NA
"3098","VT","501","Burlington/Chittenden County CoC",532,442,90,218,184,34,73,60,13,2014,151,114,37,31,27,4,NA,NA
"3099","WA","500","Seattle/King County CoC",8949,6213,2736,2920,2920,0,872,872,0,2014,885,518,367,685,592,93,NA,NA
"3100","WA","501","Washington Balance of State CoC",5236,3107,2129,2336,1751,585,745,560,185,2014,979,309,670,386,220,166,NA,NA
"3101","WA","502","Spokane City & County CoC",1149,994,155,452,434,18,146,140,6,2014,179,111,68,85,82,3,NA,NA
"3102","WA","503","Tacoma, Lakewood/Pierce County CoC",1464,1171,293,626,610,16,196,188,8,2014,224,95,129,162,129,33,NA,NA
"3103","WA","504","Everett/Snohomish County CoC",949,577,372,335,292,43,105,90,15,2014,188,67,121,65,30,35,NA,NA
"3104","WA","508","Vancouver/Clark County CoC",695,478,217,383,276,107,118,81,37,2014,80,29,51,50,36,14,NA,NA
"3105","WI","500","Wisconsin Balance of State CoC",3569,3446,123,2089,2025,64,694,669,25,2014,246,239,7,259,256,3,NA,NA
"3106","WI","501","Milwaukee City & County CoC",1499,1384,115,612,588,24,179,175,4,2014,127,94,33,164,154,10,NA,NA
"3107","WI","502","Racine City & County CoC",210,199,11,87,87,0,27,27,0,2014,12,12,0,35,35,0,NA,NA
"3108","WI","503","Madison/Dane County CoC",777,683,94,338,336,2,107,106,1,2014,139,102,37,62,51,11,NA,NA
"3109","WV","500","Wheeling, Weirton Area CoC",97,88,9,34,29,5,11,9,2,2014,23,20,3,5,4,1,NA,NA
"3110","WV","501","Huntington/Cabell, Wayne Counties CoC",218,208,10,100,100,0,35,35,0,2014,50,43,7,18,15,3,NA,NA
"3111","WV","503","Charleston/Kanawha, Putnam, Boone, Clay Counties CoC",360,347,13,79,79,0,26,26,0,2014,51,45,6,31,29,2,NA,NA
"3112","WV","508","West Virginia Balance of State CoC",1338,940,398,312,200,112,101,61,40,2014,358,196,162,279,255,24,NA,NA
"3113","WY","500","Wyoming Statewide CoC",757,563,194,294,236,58,89,76,13,2014,144,104,40,116,95,21,NA,NA
"3114",NA,NA,"Total",576450,401051,175399,216261,191903,24358,67613,59629,7984,2014,99132,40565,58567,49689,32119,17570,NA,NA
"3115","AK","500","Anchorage CoC",1208,1029,179,371,350,21,101,94,7,2015,127,27,100,130,108,22,12,NA
"3116","AK","501","Alaska Balance of State CoC",748,610,138,243,205,38,79,69,10,2015,95,54,41,50,41,9,12,NA
"3117","AL","500","Birmingham/Jefferson, St. Clair, Shelby Counties CoC",1153,916,237,267,255,12,88,84,4,2015,241,35,206,144,133,11,9,NA
"3118","AL","501","Mobile City & County/Baldwin County CoC",578,364,214,108,87,21,35,29,6,2015,107,25,82,94,66,28,1,NA
"3119","AL","502","Florence/Northwest Alabama CoC",245,214,31,87,81,6,26,24,2,2015,28,14,14,16,11,5,0,NA
"3120","AL","503","Huntsville/North Alabama CoC",420,357,63,120,116,4,37,36,1,2015,119,83,36,39,33,6,3,NA
"3121","AL","504","Montgomery City & County CoC",441,373,68,108,93,15,36,32,4,2015,24,2,22,40,35,5,2,NA
"3122","AL","505","Gadsden/Northeast Alabama CoC",156,103,53,16,16,0,7,7,0,2015,2,2,0,11,9,2,14,NA
"3123","AL","506","Tuscaloosa City & County CoC",339,144,195,151,18,133,47,4,43,2015,50,0,50,81,77,4,0,NA
"3124","AL","507","Alabama Balance of State CoC",638,472,166,245,201,44,84,71,13,2015,36,7,29,49,35,14,3,NA
"3125","AR","500","Little Rock/Central Arkansas CoC",830,491,339,66,61,5,25,23,2,2015,220,78,142,190,153,37,0,NA
"3126","AR","501","Fayetteville/Northwest Arkansas CoC",665,604,61,335,331,4,104,102,2,2015,202,172,30,197,186,11,0,NA
"3127","AR","503","Arkansas  Balance of State  CoC",774,385,389,269,140,129,94,56,38,2015,109,33,76,22,14,8,0,NA
"3128","AR","504","Delta Hills CoC",40,40,0,7,7,0,2,2,0,2015,0,0,0,12,12,0,0,NA
"3129","AR","505","Southeast Arkansas CoC",72,71,1,21,21,0,6,6,0,2015,2,2,0,2,2,0,0,NA
"3130","AR","508","Fort Smith CoC",179,87,92,29,29,0,9,9,0,2015,90,34,56,33,18,15,0,NA
"3131","AR","512","Boone, Baxter, Marion, Newton Counties CoC",NA,NA,NA,NA,NA,NA,NA,NA,NA,2015,NA,NA,NA,NA,NA,NA,NA,NA
"3132","AZ","500","Arizona Balance of State CoC",2402,1097,1305,679,464,215,202,143,59,2015,542,20,522,516,107,409,20,NA
"3133","AZ","501","Tucson/Pima County CoC",1863,1500,363,567,549,18,179,173,6,2015,344,102,242,285,246,39,9,NA
"3134","AZ","502","Phoenix, Mesa/Maricopa County CoC",5631,4342,1289,2102,2102,0,621,621,0,2015,480,222,258,419,319,100,54,NA
"3135","CA","500","San Jose/Santa Clara City & County CoC",6556,1929,4627,908,845,63,266,249,17,2015,2207,189,2018,703,257,446,59,NA
"3136","CA","501","San Francisco CoC",6775,2417,4358,600,567,33,212,201,11,2015,1629,415,1214,557,205,352,125,NA
"3137","CA","502","Oakland, Berkeley/Alameda County CoC",4040,1643,2397,985,741,244,324,277,47,2015,750,211,539,388,157,231,13,NA
"3138","CA","503","Sacramento City & County CoC",2659,1711,948,734,697,37,238,227,11,2015,502,184,318,313,171,142,7,NA
"3139","CA","504","Santa Rosa, Petaluma/Sonoma County CoC",3097,1037,2060,367,344,23,127,119,8,2015,702,114,588,215,79,136,48,NA
"3140","CA","505","Richmond/Contra Costa County CoC",2031,704,1327,397,318,79,116,91,25,2015,621,212,409,122,44,78,0,NA
"3141","CA","506","Salinas/Monterey, San Benito Counties CoC",2959,852,2107,453,440,13,147,143,4,2015,598,36,562,176,55,121,46,NA
"3142","CA","507","Marin County CoC",1318,483,835,203,194,9,57,55,2,2015,281,48,233,66,25,41,6,NA
"3143","CA","508","Watsonville/Santa Cruz City & County CoC",1964,610,1354,481,275,206,144,93,51,2015,582,165,417,151,38,113,28,NA
"3144","CA","509","Mendocino County CoC",947,152,795,129,40,89,42,16,26,2015,112,35,77,39,10,29,0,NA
"3145","CA","510","Turlock, Modesto/Stanislaus County CoC",1408,725,683,273,203,70,78,58,20,2015,59,17,42,102,47,55,19,NA
"3146","CA","511","Stockton/San Joaquin County CoC",1708,1173,535,751,703,48,225,210,15,2015,293,83,210,144,83,61,1,NA
"3147","CA","512","Daly/San Mateo County CoC",1483,708,775,516,401,115,147,112,35,2015,319,86,233,183,93,90,5,NA
"3148","CA","513","Visalia/Kings, Tulare Counties CoC",862,417,445,137,134,3,47,46,1,2015,349,23,326,51,11,40,1,NA
"3149","CA","514","Fresno City & County/Madera County CoC",1722,539,1183,312,305,7,93,91,2,2015,368,23,345,227,87,140,3,NA
"3150","CA","515","Roseville, Rocklin/Placer, Nevada Counties CoC",796,297,499,185,110,75,61,37,24,2015,334,97,237,64,21,43,7,NA
"3151","CA","516","Redding/Shasta, Siskiyou, Lassen, Plumas, Del Norte, Modoc, Sierra Counties CoC",591,244,347,87,68,19,29,22,7,2015,298,75,223,87,39,48,0,NA
"3152","CA","517","Napa City & County CoC",293,179,114,67,67,0,21,21,0,2015,132,55,77,19,11,8,0,NA
"3153","CA","518","Vallejo/Solano County CoC",1082,287,795,114,97,17,34,28,6,2015,227,9,218,89,24,65,9,NA
"3154","CA","519","Chico, Paradise/Butte County CoC",571,286,285,99,97,2,32,31,1,2015,257,51,206,50,23,27,0,NA
"3155","CA","520","Merced City & County CoC",898,155,743,35,35,0,13,13,0,2015,221,35,186,88,14,74,0,NA
"3156","CA","521","Davis, Woodland/Yolo County CoC",498,305,193,136,126,10,39,36,3,2015,87,43,44,44,28,16,3,NA
"3157","CA","522","Humboldt County CoC",1180,244,936,158,111,47,54,34,20,2015,392,15,377,145,53,92,29,NA
"3158","CA","523","Colusa, Glenn, Trinity Counties CoC",136,56,80,56,43,13,17,13,4,2015,35,5,30,10,3,7,0,NA
"3159","CA","524","Yuba City & County/Sutter County CoC",716,205,511,296,97,199,86,28,58,2015,198,0,198,113,93,20,22,NA
"3160","CA","525","El Dorado County CoC",269,121,148,112,56,56,39,21,18,2015,104,13,91,20,9,11,6,NA
"3161","CA","526","Amador, Calaveras, Mariposa, Tuolumne Counties CoC",430,128,302,93,67,26,33,25,8,2015,101,4,97,47,13,34,0,NA
"3162","CA","527","Tehama County CoC",138,78,60,23,18,5,7,6,1,2015,34,11,23,15,7,8,0,NA
"3163","CA","529","Lake County CoC",315,27,288,104,24,80,36,9,27,2015,0,0,0,21,0,21,1,NA
"3164","CA","530","Alpine, Inyo, Mono Counties CoC",53,8,45,7,4,3,2,1,1,2015,19,1,18,8,0,8,0,NA
"3165","CA","600","Los Angeles City & County CoC",41174,12226,28948,7505,4607,2898,2419,1546,873,2015,14173,1798,12375,4016,1253,2763,280,NA
"3166","CA","601","San Diego City and County CoC",8742,4586,4156,1981,1737,244,631,544,87,2015,1689,340,1349,1381,750,631,59,NA
"3167","CA","602","Santa Ana, Anaheim/Orange County CoC",4452,2251,2201,1379,1373,6,451,449,2,2015,580,133,447,447,91,356,15,NA
"3168","CA","603","Santa Maria/Santa Barbara County CoC",1729,839,890,336,254,82,100,77,23,2015,374,43,331,128,49,79,5,NA
"3169","CA","604","Bakersfield/Kern County CoC",954,545,409,221,201,20,68,61,7,2015,167,36,131,92,61,31,0,NA
"3170","CA","606","Long Beach CoC",2345,832,1513,408,256,152,125,82,43,2015,953,204,749,308,214,94,1,NA
"3171","CA","607","Pasadena CoC",632,190,442,115,96,19,47,40,7,2015,198,16,182,36,4,32,4,NA
"3172","CA","608","Riverside City & County CoC",2372,884,1488,306,280,26,89,79,10,2015,532,113,419,223,121,102,15,NA
"3173","CA","609","San Bernardino City & County CoC",2149,838,1311,625,533,92,222,197,25,2015,564,77,487,176,31,145,22,NA
"3174","CA","611","Oxnard, San Buenaventura/Ventura County CoC",1417,460,957,333,186,147,101,58,43,2015,523,18,505,103,16,87,39,NA
"3175","CA","612","Glendale CoC",208,86,122,75,73,2,26,25,1,2015,69,18,51,6,1,5,0,NA
"3176","CA","613","Imperial County CoC",554,190,364,122,100,22,38,32,6,2015,179,20,159,8,1,7,0,NA
"3177","CA","614","San Luis Obispo County CoC",1515,392,1123,358,273,85,112,90,22,2015,415,6,409,130,17,113,14,NA
"3178","CO","500","Colorado Balance of State CoC",3545,1714,1831,1640,895,745,488,275,213,2015,744,223,521,295,137,158,6,NA
"3179","CO","503","Metropolitan Denver CoC",5335,4590,745,2296,2215,81,662,630,32,2015,842,520,322,494,400,94,75,NA
"3180","CO","504","Colorado Springs/El Paso County CoC",1073,830,243,288,285,3,92,91,1,2015,291,139,152,161,107,54,1,NA
"3181","CT","503","Bridgeport, Stamford, Norwalk/Fairfield County CoC",913,773,140,366,356,10,119,116,3,2015,127,59,68,61,52,9,11,NA
"3182","CT","505","Connecticut Balance of State CoC",3134,2648,486,962,941,21,337,329,8,2015,456,219,237,221,189,32,0,NA
"3183","DE","500","Delaware Statewide CoC",953,916,37,351,351,0,115,115,0,2015,80,75,5,79,74,5,3,NA
"3184","FL","500","Sarasota, Bradenton/Manatee, Sarasota Counties CoC",1198,721,477,220,198,22,81,71,10,2015,219,40,179,152,95,57,15,NA
"3185","FL","501","Tampa/Hillsborough County CoC",1931,1175,756,568,507,61,169,152,17,2015,315,98,217,313,161,152,0,NA
"3186","FL","502","St. Petersburg, Clearwater, Largo/Pinellas County CoC",3387,2215,1172,484,480,4,151,150,1,2015,633,117,516,589,447,142,74,NA
"3187","FL","503","Lakeland, Winterhaven/Polk County CoC",464,227,237,116,85,31,37,28,9,2015,100,8,92,44,14,30,0,NA
"3188","FL","504","Daytona Beach, Daytona/Volusia, Flagler Counties CoC",1325,550,775,395,239,156,154,76,78,2015,301,32,269,110,26,84,0,NA
"3189","FL","505","Fort Walton Beach/Okaloosa, Walton Counties CoC",683,272,411,117,117,0,41,41,0,2015,305,54,251,117,50,67,0,NA
"3190","FL","506","Tallahassee/Leon County CoC",863,646,217,238,236,2,73,72,1,2015,134,45,89,113,86,27,17,NA
"3191","FL","507","Orlando/Orange, Osceola, Seminole Counties CoC",2112,1820,292,720,699,21,224,218,6,2015,212,74,138,320,275,45,0,NA
"3192","FL","508","Gainesville/Alachua, Putnam Counties CoC",870,317,553,82,74,8,34,32,2,2015,395,43,352,217,125,92,19,NA
"3193","FL","509","Fort Pierce/St. Lucie, Indian River, Martin Counties CoC",2412,236,2176,1113,144,969,421,38,383,2015,131,6,125,68,5,63,0,NA
"3194","FL","510","Jacksonville-Duval, Clay Counties CoC",1853,1427,426,499,489,10,161,158,3,2015,353,203,150,184,128,56,17,NA
"3195","FL","511","Pensacola/Escambia, Santa Rosa Counties CoC",1014,538,476,140,121,19,40,33,7,2015,219,128,91,167,122,45,146,NA
"3196","FL","512","St. Johns County CoC",1161,198,963,264,147,117,64,37,27,2015,121,13,108,24,5,19,8,NA
"3197","FL","513","Palm Bay, Melbourne/Brevard County CoC",1072,684,388,456,440,16,136,132,4,2015,159,2,157,193,139,54,8,NA
"3198","FL","514","Ocala/Marion County CoC",787,259,528,168,92,76,55,29,26,2015,66,1,65,95,60,35,28,NA
"3199","FL","515","Panama City/Bay, Jackson Counties CoC",317,183,134,45,34,11,16,13,3,2015,25,2,23,40,12,28,6,NA
"3200","FL","517","Hendry, Hardee, Highlands Counties CoC",1218,278,940,598,198,400,166,66,100,2015,227,25,202,0,0,0,0,NA
"3201","FL","518","Columbia, Hamilton, Lafayette, Suwannee Counties CoC",1115,66,1049,239,21,218,70,7,63,2015,209,0,209,139,27,112,9,NA
"3202","FL","519","Pasco County CoC",1019,159,860,227,47,180,93,21,72,2015,433,42,391,114,44,70,126,NA
"3203","FL","520","Citrus, Hernando, Lake, Sumter Counties CoC",731,267,464,245,120,125,71,39,32,2015,38,11,27,62,21,41,0,NA
"3204","FL","600","Miami-Dade County CoC",4152,3145,1007,1432,1432,0,410,410,0,2015,526,174,352,236,213,23,11,NA
"3205","FL","601","Ft Lauderdale/Broward County CoC",2615,1796,819,516,492,24,160,151,9,2015,444,141,303,247,137,110,41,NA
"3206","FL","602","Punta Gorda/Charlotte County CoC",562,162,400,249,89,160,84,21,63,2015,156,6,150,65,36,29,21,NA
"3207","FL","603","Ft Myers, Cape Coral/Lee County CoC",614,300,314,94,64,30,31,22,9,2015,180,39,141,62,34,28,5,NA
"3208","FL","604","Monroe County CoC",615,301,314,53,41,12,19,15,4,2015,148,30,118,93,34,59,5,NA
"3209","FL","605","West Palm Beach/Palm Beach County CoC",1421,596,825,201,148,53,59,42,17,2015,452,24,428,157,71,86,35,NA
"3210","FL","606","Naples/Collier County CoC",389,345,44,96,96,0,33,33,0,2015,39,25,14,5,5,0,2,NA
"3211","GA","500","Atlanta CoC",4317,3280,1037,565,559,6,187,184,3,2015,781,416,365,633,482,151,2,NA
"3212","GA","501","Georgia Balance of State CoC",5797,2279,3518,2414,1628,786,691,498,193,2015,931,98,833,553,133,420,4,NA
"3213","GA","502","Fulton County CoC",473,420,53,201,194,7,73,71,2,2015,47,28,19,57,57,0,8,NA
"3214","GA","503","Athens-Clarke County CoC",226,135,91,38,38,0,11,11,0,2015,32,5,27,20,11,9,0,NA
"3215","GA","504","Augusta-Richmond County CoC",407,278,129,142,82,60,42,26,16,2015,34,14,20,71,36,35,0,NA
"3216","GA","505","Columbus-Muscogee/Russell County CoC",371,206,165,48,48,0,18,18,0,2015,59,5,54,37,11,26,0,NA
"3217","GA","506","Marietta/Cobb County CoC",415,324,91,207,185,22,68,61,7,2015,49,8,41,22,10,12,0,NA
"3218","GA","507","Savannah/Chatham County CoC",1100,578,522,147,147,0,55,55,0,2015,121,46,75,48,32,16,1,NA
"3219","GA","508","DeKalb County CoC",684,487,197,326,323,3,91,90,1,2015,83,2,81,107,94,13,0,NA
"3220","HI","500","Hawaii Balance of State CoC",2717,813,1904,973,479,494,242,128,114,2015,666,20,646,225,35,190,3,NA
"3221","HI","501","Honolulu City and County CoC",4903,2964,1939,2340,2055,285,556,485,71,2015,868,160,708,467,240,227,21,NA
"3222","IA","500","Sioux City/Dakota, Woodbury Counties CoC",276,265,11,163,163,0,49,49,0,2015,26,25,1,14,13,1,0,NA
"3223","IA","501","Iowa Balance of State CoC",1975,1876,99,1154,1150,4,355,354,1,2015,135,126,9,81,64,17,4,NA
"3224","IA","502","Des Moines/Polk County CoC",830,737,93,263,263,0,92,92,0,2015,114,70,44,112,98,14,3,NA
"3225","ID","500","Boise/Ada County CoC",755,674,81,144,140,4,46,44,2,2015,94,67,27,126,112,14,3,NA
"3226","ID","501","Idaho Balance of State CoC",1211,823,388,650,525,125,205,169,36,2015,151,45,106,123,62,61,1,NA
"3227","IL","500","McHenry County CoC",177,168,9,61,55,6,20,18,2,2015,6,4,2,25,25,0,0,NA
"3228","IL","501","Rockford/Winnebago, Boone Counties CoC",327,298,29,130,130,0,47,47,0,2015,31,22,9,20,19,1,10,NA
"3229","IL","502","Waukegan, North Chicago/Lake County CoC",386,381,5,189,189,0,62,62,0,2015,46,45,1,58,58,0,0,NA
"3230","IL","503","Champaign, Urbana, Rantoul/Champaign County CoC",163,153,10,38,38,0,12,12,0,2015,5,0,5,18,16,2,5,NA
"3231","IL","504","Madison County CoC",168,144,24,130,121,9,39,37,2,2015,28,15,13,10,10,0,0,NA
"3232","IL","506","Joliet, Bolingbrook/Will County CoC",340,314,26,133,130,3,39,38,1,2015,49,35,14,23,23,0,0,NA
"3233","IL","507","Peoria, Pekin/Fulton, Tazewell, Peoria, Woodford Counties CoC",451,383,68,189,150,39,56,46,10,2015,76,64,12,29,23,6,0,NA
"3234","IL","508","East St. Louis, Belleville/St. Clair County CoC",318,166,152,142,114,28,44,35,9,2015,101,17,84,38,23,15,0,NA
"3235","IL","509","Dekalb City & County CoC",101,99,2,56,56,0,16,16,0,2015,0,0,0,1,1,0,0,NA
"3236","IL","510","Chicago CoC",6786,4731,2055,2194,2173,21,684,677,7,2015,1066,389,677,752,346,406,8,NA
"3237","IL","511","Cook County CoC",895,785,110,367,367,0,126,126,0,2015,106,81,25,92,85,7,2,NA
"3238","IL","512","Bloomington/Central Illinois CoC",619,565,54,381,344,37,155,140,15,2015,63,47,16,20,19,1,1,NA
"3239","IL","513","Springfield/Sangamon County CoC",326,311,15,99,99,0,31,31,0,2015,30,23,7,28,24,4,2,NA
"3240","IL","514","DuPage County CoC",672,642,30,382,382,0,131,131,0,2015,54,50,4,21,20,1,8,NA
"3241","IL","515","South Central Illinois CoC",122,98,24,78,70,8,24,22,2,2015,12,12,0,9,9,0,2,NA
"3242","IL","516","Decatur/Macon County CoC",238,199,39,68,65,3,23,22,1,2015,70,48,22,10,6,4,0,NA
"3243","IL","517","Aurora, Elgin/Kane County CoC",388,374,14,121,121,0,41,41,0,2015,87,78,9,22,21,1,0,NA
"3244","IL","518","Rock Island, Moline/Northwestern Illinois CoC",254,238,16,74,71,3,27,26,1,2015,31,18,13,20,16,4,0,NA
"3245","IL","519","West Central Illinois CoC",100,98,2,39,39,0,12,12,0,2015,8,8,0,3,3,0,0,NA
"3246","IL","520","Southern Illinois CoC",346,316,30,154,150,4,59,58,1,2015,43,38,5,27,22,5,0,NA
"3247","IN","502","Indiana Balance of State CoC",4197,3725,472,1512,1498,14,500,497,3,2015,488,369,119,401,350,51,28,NA
"3248","IN","503","Indianapolis CoC",1666,1555,111,437,429,8,136,134,2,2015,215,160,55,389,376,13,8,NA
"3249","KS","502","Wichita/Sedgwick County CoC",561,462,99,150,150,0,49,49,0,2015,94,55,39,59,41,18,0,NA
"3250","KS","503","Topeka/Shawnee County CoC",405,372,33,145,145,0,49,49,0,2015,82,56,26,34,34,0,0,NA
"3251","KS","505","Overland Park, Shawnee/Johnson County CoC",174,151,23,151,141,10,48,44,4,2015,6,3,3,0,0,0,0,NA
"3252","KS","507","Kansas Balance of State CoC",1208,1093,115,566,557,9,167,163,4,2015,152,108,44,178,166,12,1,NA
"3253","KY","500","Kentucky Balance of State CoC",2119,1497,622,877,674,203,286,219,67,2015,84,60,24,234,196,38,6,NA
"3254","KY","501","Louisville-Jefferson County CoC",1161,1080,81,307,297,10,110,108,2,2015,145,131,14,190,179,11,14,NA
"3255","KY","502","Lexington-Fayette County CoC",1258,1219,39,203,203,0,71,71,0,2015,228,222,6,167,166,1,7,NA
"3256","LA","500","Lafayette/Acadiana CoC",493,373,120,166,164,2,58,57,1,2015,68,31,37,48,38,10,0,NA
"3257","LA","502","Shreveport, Bossier/Northwest Louisiana CoC",390,310,80,86,86,0,31,31,0,2015,116,64,52,96,90,6,2,NA
"3258","LA","503","New Orleans/Jefferson Parish CoC",1703,914,789,193,190,3,63,62,1,2015,423,108,315,108,96,12,13,NA
"3259","LA","505","Monroe/Northeast Louisiana CoC",191,170,21,106,106,0,34,34,0,2015,19,3,16,8,6,2,5,NA
"3260","LA","506","Slidell/Southeast Louisiana CoC",243,193,50,100,85,15,28,24,4,2015,36,28,8,40,39,1,0,NA
"3261","LA","507","Alexandria/Central Louisiana CoC",154,130,24,32,32,0,9,9,0,2015,17,8,9,4,1,3,0,NA
"3262","LA","509","Louisiana Balance of State CoC",907,800,107,181,174,7,62,59,3,2015,94,45,49,88,80,8,10,NA
"3263","MA","500","Boston CoC",6492,6353,139,3953,3953,0,1377,1377,0,2015,957,922,35,383,374,9,1,NA
"3264","MA","502","Lynn CoC",445,428,17,285,285,0,79,79,0,2015,10,4,6,7,7,0,0,NA
"3265","MA","503","Cape Cod Islands CoC",362,315,47,170,161,9,66,63,3,2015,78,57,21,31,26,5,0,NA
"3266","MA","504","Springfield/Hampden County CoC",3002,2992,10,2628,2628,0,787,787,0,2015,293,289,4,38,38,0,1,NA
"3267","MA","505","New Bedford CoC",437,387,50,196,196,0,73,73,0,2015,43,10,33,42,38,4,1,NA
"3268","MA","506","Worcester City & County CoC",1682,1606,76,1164,1160,4,365,363,2,2015,61,40,21,181,178,3,0,NA
"3269","MA","507","Pittsfield/Berkshire, Franklin, Hampshire Counties CoC",781,762,19,367,367,0,122,122,0,2015,107,95,12,220,220,0,0,NA
"3270","MA","508","Lowell CoC",635,609,26,406,406,0,119,119,0,2015,77,63,14,44,43,1,0,NA
"3271","MA","509","Cambridge CoC",464,432,32,126,126,0,50,50,0,2015,97,67,30,17,14,3,0,NA
"3272","MA","510","Gloucester, Haverhill, Salem/Essex County CoC",1577,1544,33,1340,1336,4,514,513,1,2015,273,264,9,28,28,0,0,NA
"3273","MA","511","Quincy, Brockton, Weymouth, Plymouth City and County CoC",1803,1775,28,1413,1413,0,484,484,0,2015,256,233,23,64,63,1,0,NA
"3274","MA","515","Fall River CoC",406,406,0,281,281,0,86,86,0,2015,61,61,0,3,3,0,0,NA
"3275","MA","516","Massachusetts Balance of State CoC",2651,2582,69,2213,2201,12,715,710,5,2015,216,199,17,53,50,3,2,NA
"3276","MA","517","Somerville CoC",158,152,6,51,51,0,21,21,0,2015,11,5,6,14,14,0,0,NA
"3277","MA","519","Attleboro, Taunton/Bristol County CoC",240,199,41,164,164,0,45,45,0,2015,21,11,10,8,5,3,0,NA
"3278","MD","500","Cumberland/Allegany County CoC",96,77,19,48,44,4,17,16,1,2015,11,3,8,0,0,0,0,NA
"3279","MD","501","Baltimore CoC",2796,2459,337,603,603,0,210,210,0,2015,556,388,168,373,338,35,15,NA
"3280","MD","502","Harford County CoC",210,207,3,132,132,0,41,41,0,2015,51,48,3,6,6,0,8,NA
"3281","MD","503","Annapolis/Anne Arundel County CoC",335,287,48,111,111,0,34,34,0,2015,71,46,25,28,24,4,0,NA
"3282","MD","504","Howard County CoC",166,123,43,83,80,3,26,25,1,2015,35,18,17,3,2,1,0,NA
"3283","MD","505","Baltimore County CoC",745,450,295,312,236,76,98,83,15,2015,213,73,140,43,14,29,0,NA
"3284","MD","506","Carroll County CoC",140,129,11,68,63,5,18,17,1,2015,32,23,9,4,3,1,0,NA
"3285","MD","507","Cecil County CoC",191,156,35,47,42,5,17,15,2,2015,32,14,18,76,74,2,0,NA
"3286","MD","508","Charles, Calvert, St.Mary's Counties CoC",981,412,569,434,169,265,141,49,92,2015,425,161,264,40,19,21,20,NA
"3287","MD","509","Frederick City & County CoC",311,251,60,130,130,0,37,37,0,2015,89,38,51,13,5,8,0,NA
"3288","MD","510","Garrett County CoC",9,9,0,7,7,0,2,2,0,2015,0,0,0,0,0,0,0,NA
"3289","MD","511","Mid-Shore Regional CoC",158,123,35,53,47,6,17,15,2,2015,22,12,10,9,6,3,0,NA
"3290","MD","512","Hagerstown/Washington County CoC",201,164,37,53,50,3,17,16,1,2015,54,38,16,34,32,2,2,NA
"3291","MD","513","Wicomico, Somerset, Worcester Counties CoC",326,278,48,67,67,0,23,23,0,2015,51,27,24,26,23,3,1,NA
"3292","MD","600","Prince George's County CoC",625,472,153,357,324,33,113,105,8,2015,43,14,29,35,20,15,8,NA
"3293","MD","601","Montgomery County CoC",1100,997,103,502,502,0,159,159,0,2015,162,113,49,24,20,4,0,NA
"3294","ME","500","Maine Statewide CoC",2372,2313,59,1153,1143,10,358,355,3,2015,217,203,14,151,142,9,18,NA
"3295","MI","500","Michigan Balance of State CoC",1745,1523,222,806,773,33,286,276,10,2015,56,37,19,94,76,18,61,NA
"3296","MI","501","Detroit CoC",2597,2446,151,633,633,0,209,209,0,2015,263,183,80,486,480,6,22,NA
"3297","MI","502","Dearborn, Dearborn Heights, Westland/Wayne County CoC",333,322,11,182,182,0,55,55,0,2015,7,6,1,17,16,1,6,NA
"3298","MI","503","St. Clair Shores, Warren/Macomb County CoC",450,381,69,110,110,0,33,33,0,2015,39,16,23,51,49,2,1,NA
"3299","MI","504","Pontiac, Royal Oak/Oakland County CoC",485,389,96,170,170,0,58,58,0,2015,51,48,3,13,13,0,4,NA
"3300","MI","505","Flint/Genesee County CoC",488,308,180,150,141,9,50,46,4,2015,95,18,77,46,28,18,13,NA
"3301","MI","506","Grand Rapids, Wyoming/Kent County CoC",912,886,26,439,439,0,136,136,0,2015,50,43,7,95,91,4,16,NA
"3302","MI","507","Portage, Kalamazoo City & County CoC",568,560,8,351,351,0,107,107,0,2015,22,22,0,7,7,0,12,NA
"3303","MI","508","Lansing, East Lansing/Ingham County CoC",418,365,53,125,125,0,37,37,0,2015,78,54,24,51,47,4,3,NA
"3304","MI","509","Washtenaw County CoC",372,292,80,63,63,0,17,17,0,2015,89,64,25,49,44,5,1,NA
"3305","MI","510","Saginaw City & County CoC",308,289,19,118,113,5,36,35,1,2015,24,23,1,16,15,1,1,NA
"3306","MI","511","Lenawee County CoC",128,110,18,73,59,14,22,18,4,2015,19,16,3,6,6,0,2,NA
"3307","MI","512","Grand Traverse, Antrim, Leelanau Counties CoC",302,265,37,76,76,0,30,30,0,2015,49,26,23,10,9,1,8,NA
"3308","MI","513","Marquette, Alger Counties CoC",79,77,2,37,37,0,13,13,0,2015,6,4,2,11,10,1,0,NA
"3309","MI","514","Battle Creek/Calhoun County CoC",285,226,59,96,84,12,26,23,3,2015,43,26,17,58,44,14,0,NA
"3310","MI","515","Monroe City & County CoC",185,181,4,56,56,0,23,23,0,2015,6,5,1,36,36,0,1,NA
"3311","MI","516","Norton Shores, Muskegon City & County CoC",179,166,13,54,54,0,18,18,0,2015,5,2,3,4,4,0,4,NA
"3312","MI","517","Jackson City & County CoC",159,152,7,103,100,3,34,33,1,2015,6,5,1,3,3,0,0,NA
"3313","MI","518","Livingston County CoC",103,101,2,55,55,0,18,18,0,2015,2,1,1,8,8,0,4,NA
"3314","MI","519","Holland/Ottawa County CoC",285,279,6,149,149,0,43,43,0,2015,23,22,1,4,3,1,1,NA
"3315","MI","523","Eaton County CoC",135,126,9,124,121,3,34,33,1,2015,2,0,2,2,2,0,0,NA
"3316","MN","500","Minneapolis/Hennepin County CoC",3215,3092,123,1704,1701,3,473,472,1,2015,637,572,65,127,123,4,37,NA
"3317","MN","501","Saint Paul/Ramsey County CoC",1398,1314,84,660,634,26,226,213,13,2015,281,217,64,59,52,7,21,NA
"3318","MN","502","Rochester/Southeast Minnesota CoC",451,429,22,329,325,4,105,103,2,2015,69,64,5,8,5,3,0,NA
"3319","MN","503","Dakota, Anoka, Washington, Scott, Carver Counties",608,428,180,310,269,41,92,78,14,2015,64,46,18,28,25,3,33,NA
"3320","MN","504","Northeast Minnesota CoC",68,45,23,36,24,12,11,7,4,2015,18,0,18,3,3,0,3,NA
"3321","MN","505","St. Cloud/Central Minnesota CoC",696,491,205,316,232,84,105,81,24,2015,12,9,3,29,19,10,24,NA
"3322","MN","506","Northwest Minnesota CoC",254,239,15,140,136,4,46,45,1,2015,60,46,14,10,7,3,1,NA
"3323","MN","508","Moorhead/West Central Minnesota CoC",242,234,8,128,124,4,36,35,1,2015,40,39,1,5,5,0,1,NA
"3324","MN","509","Duluth/St.Louis County CoC",490,323,167,207,182,25,69,59,10,2015,205,54,151,26,14,12,11,NA
"3325","MN","511","Southwest Minnesota CoC",124,110,14,94,91,3,29,28,1,2015,10,7,3,2,0,2,0,NA
"3326","MO","500","St. Louis County CoC",438,379,59,233,192,41,70,63,7,2015,30,16,14,28,27,1,14,NA
"3327","MO","501","St.Louis City CoC",1312,1200,112,754,739,15,205,202,3,2015,110,33,77,138,125,13,1,NA
"3328","MO","503","St. Charles City & County, Lincoln, Warren Counties CoC",803,556,247,548,420,128,153,113,40,2015,58,33,25,3,2,1,13,NA
"3329","MO","600","Springfield/Greene, Christian, Webster Counties CoC",584,409,175,245,245,0,77,77,0,2015,161,46,115,46,10,36,11,NA
"3330","MO","602","Joplin/Jasper, Newton Counties CoC",258,238,20,98,98,0,34,34,0,2015,45,36,9,52,50,2,4,NA
"3331","MO","603","St. Joseph/Andrew, Buchanan, DeKalb Counties CoC",164,156,8,57,57,0,20,20,0,2015,65,60,5,12,11,1,0,NA
"3332","MO","604a","Kansas City, Independence, Lee’s Summit/Jackson, Wyandotte Counties, MO & KS",1686,1530,156,620,589,31,209,196,13,2015,433,340,93,162,133,29,25,NA
"3333","MO","606","Missouri Balance of State CoC",1477,1148,329,603,530,73,191,169,22,2015,168,111,57,139,107,32,35,NA
"3334","MS","500","Jackson/Rankin, Madison Counties CoC",762,426,336,138,138,0,34,34,0,2015,104,18,86,69,21,48,20,NA
"3335","MS","501","Mississippi Balance of State CoC",809,566,243,301,252,49,90,78,12,2015,85,25,60,79,58,21,5,NA
"3336","MS","503","Gulf Port/Gulf Coast Regional CoC",412,149,263,69,58,11,28,26,2,2015,54,24,30,58,8,50,0,NA
"3337","MT","500","Montana Statewide CoC",1709,837,872,582,359,223,182,120,62,2015,166,26,140,277,98,179,13,NA
"3338","NC","500","Winston-Salem/Forsyth County CoC",571,549,22,153,153,0,52,52,0,2015,98,90,8,60,58,2,0,NA
"3339","NC","501","Asheville/Buncombe County CoC",562,488,74,52,52,0,19,19,0,2015,74,22,52,209,194,15,8,NA
"3340","NC","502","Durham City & County CoC",813,769,44,157,157,0,48,48,0,2015,59,47,12,138,133,5,0,NA
"3341","NC","503","North Carolina Balance of State CoC",3021,2361,660,1099,989,110,348,310,38,2015,360,176,184,137,99,38,25,NA
"3342","NC","504","Greensboro, High Point CoC",665,551,114,153,153,0,43,43,0,2015,78,31,47,81,72,9,9,NA
"3343","NC","505","Charlotte/Mecklenberg CoC",2001,1821,180,758,758,0,256,256,0,2015,280,169,111,185,160,25,12,NA
"3344","NC","506","Wilmington/Brunswick, New Hanover, Pender Counties CoC",390,269,121,91,69,22,28,20,8,2015,80,36,44,54,39,15,8,NA
"3345","NC","507","Raleigh/Wake County CoC",904,756,148,288,285,3,85,84,1,2015,90,48,42,123,101,22,3,NA
"3346","NC","509","Gastonia/Cleveland, Gaston, Lincoln Counties CoC",281,244,37,66,62,4,22,21,1,2015,64,42,22,23,20,3,14,NA
"3347","NC","511","Fayetteville/Cumberland County CoC",593,227,366,146,136,10,47,44,3,2015,131,4,127,58,14,44,0,NA
"3348","NC","513","Chapel Hill/Orange County CoC",129,109,20,28,28,0,9,9,0,2015,25,12,13,12,11,1,0,NA
"3349","NC","516","Northwest North Carolina CoC",755,116,639,538,46,492,153,15,138,2015,25,5,20,12,3,9,0,NA
"3350","ND","500","North Dakota Statewide CoC",1305,819,486,441,228,213,123,71,52,2015,138,68,70,137,90,47,18,NA
"3351","NE","500","Nebraska Balance of State CoC",549,525,24,340,340,0,113,113,0,2015,13,12,1,16,9,7,9,NA
"3352","NE","501","Omaha, Council Bluffs CoC",1481,1437,44,443,443,0,136,136,0,2015,262,231,31,150,145,5,4,NA
"3353","NE","502","Lincoln CoC",714,659,55,241,241,0,78,78,0,2015,47,23,24,81,77,4,16,NA
"3354","NH","500","New Hampshire Balance of State CoC",718,642,76,328,313,15,107,103,4,2015,212,175,37,36,26,10,0,NA
"3355","NH","501","Manchester CoC",400,352,48,192,190,2,74,73,1,2015,56,40,16,34,33,1,1,NA
"3356","NH","502","Nashua/Hillsborough County CoC",327,319,8,147,144,3,63,62,1,2015,49,45,4,68,65,3,5,NA
"3357","NJ","500","Atlantic City & County CoC",548,474,74,109,107,2,40,39,1,2015,113,73,40,65,54,11,0,NA
"3358","NJ","501","Bergen County CoC",340,307,33,116,116,0,39,39,0,2015,28,17,11,22,17,5,6,NA
"3359","NJ","502","Burlington County CoC",1347,1339,8,688,688,0,208,208,0,2015,200,198,2,19,16,3,5,NA
"3360","NJ","503","Camden City & County/Gloucester, Cape May, Cumberland Counties CoC",1089,954,135,327,318,9,102,100,2,2015,103,64,39,144,136,8,4,NA
"3361","NJ","504","Newark/Essex County CoC",1610,1448,162,528,528,0,222,222,0,2015,152,64,88,59,42,17,15,NA
"3362","NJ","506","Jersey City, Bayonne/Hudson County CoC",917,748,169,285,279,6,106,104,2,2015,177,80,97,43,32,11,0,NA
"3363","NJ","507","New Brunswick/Middlesex County CoC",604,528,76,261,256,5,92,90,2,2015,86,61,25,22,21,1,0,NA
"3364","NJ","508","Monmouth County CoC",456,420,36,246,246,0,86,86,0,2015,99,81,18,11,5,6,0,NA
"3365","NJ","509","Morris County CoC",384,350,34,152,152,0,48,48,0,2015,49,40,9,12,10,2,0,NA
"3366","NJ","510","Lakewood Township/Ocean County CoC",605,588,17,359,355,4,120,119,1,2015,172,165,7,7,6,1,1,NA
"3367","NJ","511","Paterson/Passaic County CoC",459,429,30,218,218,0,83,83,0,2015,43,29,14,8,5,3,1,NA
"3368","NJ","512","Salem County CoC",38,37,1,20,20,0,6,6,0,2015,2,1,1,1,1,0,1,NA
"3369","NJ","513","Somerset County CoC",342,337,5,95,95,0,33,33,0,2015,34,32,2,162,162,0,12,NA
"3370","NJ","514","Trenton/Mercer County CoC",600,495,105,162,162,0,57,57,0,2015,75,11,64,31,20,11,2,NA
"3371","NJ","515","Elizabeth/Union County CoC",504,421,83,259,207,52,75,64,11,2015,36,19,17,15,14,1,0,NA
"3372","NJ","516","Warren, Sussex, Hunterdon Counties CoC",255,249,6,84,84,0,29,29,0,2015,41,37,4,75,75,0,0,NA
"3373","NM","500","Albuquerque CoC",1287,1104,183,408,399,9,121,119,2,2015,260,170,90,188,172,16,25,NA
"3374","NM","501","New Mexico Balance of State CoC",1342,1071,271,555,539,16,175,171,4,2015,456,275,181,90,42,48,29,NA
"3375","NV","500","Las Vegas/Clark County CoC",7509,3593,3916,631,628,3,197,196,1,2015,458,38,420,692,375,317,825,NA
"3376","NV","501","Reno, Sparks/Washoe County CoC",907,794,113,169,169,0,54,54,0,2015,90,52,38,157,136,21,0,NA
"3377","NV","502","Nevada Balance of State CoC",327,141,186,85,85,0,28,28,0,2015,46,27,19,11,5,6,0,NA
"3378","NY","500","Rochester, Irondequoit, Greece/Monroe County CoC",762,727,35,356,356,0,124,124,0,2015,49,39,10,51,47,4,18,NA
"3379","NY","501","Elmira/Steuben, Allegany, Livingston, Chemung, Schuyler Counties CoC",648,477,171,295,247,48,104,90,14,2015,92,0,92,47,18,29,1,NA
"3380","NY","503","Albany City & County CoC",597,577,20,138,138,0,51,51,0,2015,87,68,19,75,73,2,11,NA
"3381","NY","504","Cattaragus County CoC",41,41,0,23,23,0,8,8,0,2015,0,0,0,1,1,0,0,NA
"3382","NY","505","Syracuse, Auburn/Onondaga, Oswego, Cayuga Counties CoC",922,906,16,272,272,0,97,97,0,2015,86,83,3,48,48,0,26,NA
"3383","NY","507","Schenectady City & County CoC",349,322,27,135,135,0,48,48,0,2015,44,36,8,8,8,0,2,NA
"3384","NY","508","Buffalo, Niagara Falls/Erie, Niagara, Orleans, Genesee, Wyoming Counties CoC",919,858,61,306,306,0,108,108,0,2015,85,62,23,88,83,5,21,NA
"3385","NY","510","Ithaca/Tompkins County CoC",88,72,16,33,33,0,12,12,0,2015,9,4,5,2,0,2,3,NA
"3386","NY","511","Binghamton, Union Town/Broome, Otsego, Chenango, Delaware, Cortland, Tioga Count",302,262,40,30,30,0,10,10,0,2015,8,0,8,4,4,0,0,NA
"3387","NY","512","Troy/Rensselaer County CoC",189,147,42,77,77,0,26,26,0,2015,46,27,19,10,9,1,0,NA
"3388","NY","513","Wayne, Ontario, Seneca, Yates Counties CoC",187,187,0,7,7,0,3,3,0,2015,38,38,0,35,35,0,0,NA
"3389","NY","514","Jamestown, Dunkirk/Chautauqua County CoC",29,29,0,9,9,0,2,2,0,2015,23,23,0,0,0,0,0,NA
"3390","NY","516","Clinton County CoC",143,140,3,55,55,0,12,12,0,2015,15,12,3,0,0,0,0,NA
"3391","NY","518","Utica, Rome/Oneida, Madison Counties CoC",140,123,17,51,51,0,21,21,0,2015,41,32,9,4,0,4,3,NA
"3392","NY","519","Columbia, Greene Counties CoC",97,95,2,56,56,0,19,19,0,2015,24,23,1,0,0,0,0,NA
"3393","NY","520","Franklin, Essex Counties CoC",28,28,0,11,11,0,3,3,0,2015,3,3,0,2,2,0,0,NA
"3394","NY","522","Jefferson, Lewis, St. Lawrence Counties CoC",86,82,4,9,9,0,3,3,0,2015,8,5,3,6,6,0,0,NA
"3395","NY","523","Glens Falls, Saratoga Springs/Saratoga, Washington, Warren, Hamilton Counties Co",282,282,0,80,80,0,30,30,0,2015,36,36,0,40,40,0,3,NA
"3396","NY","600","New York City CoC",75323,72140,3183,45711,45711,0,13233,13233,0,2015,5830,3794,2036,1558,1499,59,3,NA
"3397","NY","601","Poughkeepsie/Dutchess County CoC",375,360,15,198,198,0,77,77,0,2015,31,31,0,10,7,3,7,NA
"3398","NY","602","Newburgh, Middletown/Orange County CoC",495,350,145,187,187,0,62,62,0,2015,119,52,67,21,13,8,13,NA
"3399","NY","603","Nassau, Suffolk Counties CoC",3861,3756,105,2808,2808,0,863,863,0,2015,200,169,31,192,185,7,3,NA
"3400","NY","604","Yonkers, Mount Vernon/Westchester County CoC",1797,1770,27,1066,1066,0,375,375,0,2015,175,156,19,181,179,2,6,NA
"3401","NY","606","Rockland County CoC",117,92,25,28,28,0,11,11,0,2015,1,1,0,1,1,0,0,NA
"3402","NY","607","Sullivan County CoC",130,128,2,35,35,0,12,12,0,2015,17,17,0,0,0,0,0,NA
"3403","NY","608","Kingston/Ulster County CoC",343,277,66,139,128,11,47,44,3,2015,49,22,27,15,10,5,13,NA
"3404","OH","500","Cincinnati/Hamilton County CoC",1063,1013,50,244,244,0,76,76,0,2015,175,175,0,203,199,4,12,NA
"3405","OH","501","Toledo/Lucas County CoC",564,548,16,164,162,2,53,52,1,2015,42,36,6,33,31,2,0,NA
"3406","OH","502","Cleveland/Cuyahoga County CoC",1943,1875,68,393,393,0,111,111,0,2015,217,179,38,326,308,18,0,NA
"3407","OH","503","Columbus/Franklin County CoC",1721,1523,198,337,337,0,98,98,0,2015,207,60,147,129,119,10,14,NA
"3408","OH","504","Youngstown/Mahoning County CoC",368,294,74,267,250,17,51,45,6,2015,86,50,36,35,6,29,11,NA
"3409","OH","505","Dayton, Kettering/Montgomery County CoC",971,923,48,317,317,0,98,98,0,2015,27,24,3,114,112,2,1,NA
"3410","OH","506","Akron, Barberton/Summit County CoC",760,641,119,253,236,17,77,71,6,2015,157,96,61,63,56,7,11,NA
"3411","OH","507","Ohio Balance of State CoC",3320,2854,466,1414,1328,86,460,439,21,2015,297,220,77,254,224,30,0,NA
"3412","OH","508","Canton, Massillon, Alliance/Stark County CoC",472,412,60,228,226,2,84,83,1,2015,67,47,20,26,18,8,0,NA
"3413","OK","500","North Central Oklahoma CoC",194,160,34,97,91,6,39,36,3,2015,33,20,13,6,2,4,0,NA
"3414","OK","501","Tulsa City & County CoC",956,825,131,232,227,5,71,69,2,2015,89,53,36,125,106,19,10,NA
"3415","OK","502","Oklahoma City CoC",1300,1100,200,237,237,0,82,82,0,2015,214,140,74,125,100,25,2,NA
"3416","OK","503","Oklahoma Balance of State CoC",237,121,116,80,41,39,30,15,15,2015,50,20,30,8,3,5,1,NA
"3417","OK","504","Norman/Cleveland County CoC",133,117,16,31,31,0,10,10,0,2015,30,21,9,12,8,4,1,NA
"3418","OK","505","Northeast Oklahoma CoC",343,319,24,137,128,9,42,40,2,2015,87,74,13,23,21,2,10,NA
"3419","OK","506","Southwest Oklahoma Regional CoC",161,120,41,46,43,3,18,17,1,2015,26,8,18,28,3,25,0,NA
"3420","OK","507","Southeastern Oklahoma Regional CoC",453,237,216,136,90,46,51,36,15,2015,52,6,46,24,10,14,60,NA
"3421","OR","500","Eugene, Springfield/Lane County CoC",1473,757,716,223,151,72,69,47,22,2015,697,318,379,210,110,100,23,NA
"3422","OR","501","Portland, Gresham/Multnomah County CoC",3801,1914,1887,669,511,158,218,171,47,2015,1033,158,875,417,221,196,5,NA
"3423","OR","502","Medford, Ashland/Jackson County CoC",729,347,382,109,63,46,33,21,12,2015,234,74,160,214,173,41,11,NA
"3424","OR","503","Central Oregon CoC",594,189,405,211,39,172,64,15,49,2015,222,13,209,59,17,42,12,NA
"3425","OR","505","Oregon Balance of State CoC",5544,2242,3302,2224,810,1414,693,265,428,2015,1457,401,1056,448,194,254,323,NA
"3426","OR","506","Hillsboro, Beaverton/Washington County CoC",591,196,395,192,99,93,58,30,28,2015,128,13,115,77,48,29,13,NA
"3427","OR","507","Clackamas County CoC",494,186,308,137,110,27,44,37,7,2015,240,31,209,39,6,33,1,NA
"3428","PA","500","Philadelphia CoC",5998,5328,670,2652,2652,0,906,906,0,2015,829,468,361,337,327,10,13,NA
"3429","PA","501","Harrisburg/Dauphin County CoC",402,386,16,198,198,0,70,70,0,2015,50,44,6,44,43,1,0,NA
"3430","PA","502","Upper Darby, Chester, Haverford/Delaware County CoC",436,376,60,160,160,0,56,56,0,2015,41,22,19,10,9,1,0,NA
"3431","PA","503","Wilkes-Barre, Hazleton/Luzerne County CoC",174,158,16,74,74,0,26,26,0,2015,0,0,0,13,12,1,1,NA
"3432","PA","504","Lower Merion, Norristown, Abington/Montgomery County CoC",429,426,3,249,249,0,75,75,0,2015,37,36,1,6,6,0,0,NA
"3433","PA","505","Chester County CoC",612,597,15,184,184,0,60,60,0,2015,0,0,0,299,299,0,0,NA
"3434","PA","506","Reading/Berks County CoC",561,557,4,176,176,0,66,66,0,2015,83,79,4,42,41,1,0,NA
"3435","PA","508","Scranton/Lackawanna County CoC",233,223,10,116,116,0,38,38,0,2015,28,18,10,36,36,0,0,NA
"3436","PA","509","Eastern Pennsylvania CoC",2410,1994,416,1209,1147,62,404,386,18,2015,164,87,77,150,104,46,4,NA
"3437","PA","510","Lancaster City & County CoC",378,368,10,184,184,0,66,66,0,2015,7,4,3,28,27,1,0,NA
"3438","PA","511","Bristol, Bensalem/Bucks County CoC",487,449,38,294,289,5,101,99,2,2015,38,28,10,13,9,4,10,NA
"3439","PA","512","York City & County CoC",345,301,44,187,167,20,55,49,6,2015,29,12,17,30,25,5,8,NA
"3440","PA","600","Pittsburgh, McKeesport, Penn Hills/Allegheny County CoC",1424,1386,38,505,505,0,164,164,0,2015,154,138,16,216,207,9,0,NA
"3441","PA","601","Western Pennsylvania CoC",1002,937,65,435,425,10,143,140,3,2015,91,68,23,135,134,1,1,NA
"3442","PA","603","Beaver County CoC",120,113,7,72,70,2,25,24,1,2015,9,6,3,1,1,0,0,NA
"3443","PA","605","Erie City & County CoC",410,394,16,121,121,0,44,44,0,2015,30,30,0,15,15,0,0,NA
"3444","RI","500","Rhode Island Statewide CoC",1111,1075,36,405,402,3,112,111,1,2015,130,118,12,107,105,2,4,NA
"3445","SC","500","Charleston/Low Country CoC",606,441,165,80,80,0,30,30,0,2015,117,48,69,178,163,15,0,NA
"3446","SC","501","Greenville, Anderson, Spartanburg/Upstate CoC",1961,1555,406,599,573,26,196,186,10,2015,407,275,132,101,74,27,1,NA
"3447","SC","502","Columbia/Midlands CoC",1468,1066,402,279,256,23,91,83,8,2015,319,187,132,221,193,28,4,NA
"3448","SC","503","Myrtle Beach, Sumter City & County CoC",1319,396,923,462,84,378,193,33,160,2015,177,15,162,181,40,141,8,NA
"3449","SD","500","South Dakota Statewide CoC",1036,900,136,406,394,12,125,122,3,2015,95,67,28,177,170,7,8,NA
"3450","TN","500","Chattanooga/Southeast Tennessee CoC",636,489,147,206,168,38,71,57,14,2015,126,71,55,82,65,17,0,NA
"3451","TN","501","Memphis/Shelby County CoC",1525,1447,78,518,518,0,155,155,0,2015,92,71,21,226,221,5,0,NA
"3452","TN","502","Knoxville/Knox County CoC",783,687,96,98,93,5,32,30,2,2015,108,44,64,102,95,7,0,NA
"3453","TN","503","Central Tennessee CoC",268,209,59,79,71,8,28,25,3,2015,54,39,15,56,53,3,0,NA
"3454","TN","504","Nashville-Davidson County CoC",2154,1684,470,394,394,0,130,130,0,2015,661,304,357,236,189,47,1,NA
"3455","TN","506","Upper Cumberland CoC",362,176,186,87,76,11,24,20,4,2015,36,2,34,15,0,15,0,NA
"3456","TN","507","Jackson/West Tennessee CoC",1563,151,1412,578,56,522,230,22,208,2015,255,36,219,67,11,56,0,NA
"3457","TN","509","Appalachian Regional CoC",577,425,152,139,135,4,37,36,1,2015,130,68,62,127,110,17,0,NA
"3458","TN","510","Murfreesboro/Rutherford County CoC",289,169,120,68,61,7,26,24,2,2015,39,14,25,16,10,6,0,NA
"3459","TN","512","Morristown/Blount, Sevier, Campbell, Cocke Counties CoC",966,442,524,440,232,208,136,79,57,2015,149,53,96,18,2,16,13,NA
"3460","TX","500","San Antonio/Bexar County CoC",2891,1733,1158,826,798,28,264,256,8,2015,691,351,340,284,190,94,6,NA
"3461","TX","503","Austin/Travis County CoC",1832,1165,667,566,558,8,174,172,2,2015,494,148,346,238,129,109,8,NA
"3462","TX","600","Dallas City & County, Irving CoC",3141,2778,363,922,915,7,288,286,2,2015,615,451,164,291,242,49,22,NA
"3463","TX","601","Fort Worth, Arlington/Tarrant County CoC",1914,1697,217,563,563,0,182,182,0,2015,136,109,27,193,174,19,12,NA
"3464","TX","603","El Paso City & County CoC",1107,1005,102,495,495,0,138,138,0,2015,132,106,26,92,74,18,6,NA
"3465","TX","604","Waco/McLennan County CoC",255,191,64,98,94,4,29,28,1,2015,44,18,26,30,14,16,0,NA
"3466","TX","607","Texas Balance of State CoC",7016,4090,2926,2373,1979,394,747,610,137,2015,1428,525,903,653,279,374,122,NA
"3467","TX","611","Amarillo CoC",478,472,6,160,160,0,49,49,0,2015,69,66,3,46,46,0,0,NA
"3468","TX","624","Wichita Falls/Wise, Palo Pinto, Wichita, Archer Counties CoC",267,247,20,89,89,0,32,32,0,2015,80,80,0,1,1,0,13,NA
"3469","TX","700","Houston, Pasadena, Conroe/Harris, Ft. Bend, Montgomery, Counties CoC",4609,2659,1950,1243,1229,14,390,383,7,2015,600,57,543,563,339,224,29,NA
"3470","TX","701","Bryan, College Station/Brazos Valley CoC",168,155,13,78,78,0,23,23,0,2015,15,4,11,2,2,0,0,NA
"3471","UT","500","Salt Lake City & County CoC",2176,2086,90,830,824,6,243,241,2,2015,182,174,8,288,278,10,0,NA
"3472","UT","503","Utah Balance of State CoC",646,548,98,289,276,13,91,87,4,2015,46,39,7,40,32,8,0,NA
"3473","UT","504","Provo/Mountainland CoC",203,165,38,97,94,3,30,29,1,2015,5,2,3,9,3,6,11,NA
"3474","VA","500","Richmond/Henrico, Chesterfield, Hanover Counties CoC",818,732,86,147,147,0,55,55,0,2015,124,101,23,121,115,6,0,NA
"3475","VA","501","Norfolk/Chesapeake, Suffolk, Isle of Wight, Southampton Counties CoC",735,680,55,249,247,2,77,76,1,2015,75,68,7,82,72,10,0,NA
"3476","VA","502","Roanoke City & County, Salem CoC",390,378,12,130,130,0,42,42,0,2015,80,78,2,45,43,2,0,NA
"3477","VA","503","Virginia Beach CoC",419,361,58,179,177,2,60,59,1,2015,108,68,40,58,42,16,11,NA
"3478","VA","504","Charlottesville CoC",185,160,25,58,58,0,20,20,0,2015,33,12,21,12,8,4,0,NA
"3479","VA","505","Newport News, Hampton/Virginia Peninsula CoC",520,450,70,169,164,5,49,48,1,2015,47,24,23,96,91,5,0,NA
"3480","VA","507","Portsmouth CoC",174,127,47,67,67,0,23,23,0,2015,32,12,20,9,6,3,0,NA
"3481","VA","508","Lynchburg CoC",237,227,10,87,87,0,25,25,0,2015,24,23,1,18,15,3,0,NA
"3482","VA","513","Harrisburg, Winchester/Western Virginia CoC",242,230,12,75,72,3,24,23,1,2015,61,51,10,12,10,2,0,NA
"3483","VA","514","Fredericksburg/Spotsylvania, Stafford Counties CoC",217,179,38,94,85,9,29,27,2,2015,51,17,34,13,9,4,0,NA
"3484","VA","521","Virginia Balance of State CoC",773,634,139,342,314,28,117,108,9,2015,90,42,48,38,26,12,0,NA
"3485","VA","600","Arlington County CoC",239,200,39,75,75,0,22,22,0,2015,70,51,19,19,12,7,0,NA
"3486","VA","601","Fairfax County CoC",1204,1136,68,715,715,0,213,213,0,2015,219,171,48,46,41,5,1,NA
"3487","VA","602","Loudoun County CoC",172,133,39,92,92,0,28,28,0,2015,20,10,10,5,1,4,0,NA
"3488","VA","603","Alexandria CoC",267,244,23,108,108,0,34,34,0,2015,54,38,16,12,10,2,0,NA
"3489","VA","604","Prince William County CoC",409,319,90,224,218,6,72,71,1,2015,70,23,47,18,12,6,0,NA
"3490","VT","500","Vermont Balance of State CoC",1052,984,68,480,480,0,158,158,0,2015,65,53,12,94,89,5,2,NA
"3491","VT","501","Burlington/Chittenden County CoC",471,389,82,133,118,15,43,39,4,2015,101,58,43,25,24,1,2,NA
"3492","WA","500","Seattle/King County CoC",10122,6319,3803,3069,3038,31,975,966,9,2015,823,472,351,608,499,109,42,NA
"3493","WA","501","Washington Balance of State CoC",5489,3162,2327,2328,1727,601,709,552,157,2015,975,258,717,350,180,170,49,NA
"3494","WA","502","Spokane City & County CoC",1034,902,132,382,366,16,121,115,6,2015,219,156,63,101,91,10,15,NA
"3495","WA","503","Tacoma, Lakewood/Pierce County CoC",1283,942,341,521,482,39,154,142,12,2015,202,69,133,138,60,78,5,NA
"3496","WA","504","Everett/Snohomish County CoC",829,517,312,231,215,16,80,75,5,2015,160,19,141,64,32,32,26,NA
"3497","WA","508","Vancouver/Clark County CoC",662,456,206,362,270,92,115,86,29,2015,103,53,50,32,24,8,17,NA
"3498","WI","500","Wisconsin Balance of State CoC",3597,3390,207,2102,2008,94,651,621,30,2015,238,218,20,246,243,3,0,NA
"3499","WI","501","Milwaukee City & County CoC",1521,1389,132,582,579,3,183,182,1,2015,104,85,19,192,179,13,33,NA
"3500","WI","502","Racine City & County CoC",168,157,11,59,59,0,20,20,0,2015,10,6,4,29,29,0,0,NA
"3501","WI","503","Madison/Dane County CoC",771,679,92,322,322,0,100,100,0,2015,112,68,44,67,64,3,0,NA
"3502","WV","500","Wheeling, Weirton Area CoC",114,95,19,35,35,0,11,11,0,2015,38,23,15,9,7,2,0,NA
"3503","WV","501","Huntington/Cabell, Wayne Counties CoC",227,205,22,104,104,0,29,29,0,2015,40,25,15,13,4,9,0,NA
"3504","WV","503","Charleston/Kanawha, Putnam, Boone, Clay Counties CoC",385,341,44,62,62,0,21,21,0,2015,58,40,18,37,33,4,8,NA
"3505","WV","508","West Virginia Balance of State CoC",1109,762,347,220,153,67,68,47,21,2015,250,138,112,246,183,63,3,NA
"3506","WY","500","Wyoming Statewide CoC",798,507,291,298,215,83,93,71,22,2015,102,37,65,112,83,29,4,NA
"3507",NA,NA,"Total",564708,391440,173268,206286,185824,20462,64197,58064,6133,2015,96275,36767,59508,47725,31505,16220,4667,NA
"3508","AK","500","Anchorage CoC",1105,865,240,200,200,0,69,69,0,2016,50,48,2,89,60,29,3,NA
"3509","AK","501","Alaska Balance of State CoC",835,633,202,213,209,4,66,65,1,2016,72,46,26,79,52,27,16,NA
"3510","AL","500","Birmingham/Jefferson, St. Clair, Shelby Counties CoC",1228,1032,196,301,289,12,101,98,3,2016,92,29,63,158,156,2,9,NA
"3511","AL","501","Mobile City & County/Baldwin County CoC",623,387,236,146,134,12,46,42,4,2016,80,30,50,66,56,10,0,NA
"3512","AL","502","Florence/Northwest Alabama CoC",337,286,51,143,131,12,56,53,3,2016,39,20,19,19,17,2,0,NA
"3513","AL","503","Huntsville/North Alabama CoC",385,298,87,102,102,0,29,29,0,2016,102,59,43,29,21,8,3,NA
"3514","AL","504","Montgomery City & County CoC",367,293,74,82,79,3,21,20,1,2016,28,18,10,41,40,1,0,NA
"3515","AL","505","Gadsden/Northeast Alabama CoC",167,91,76,34,21,13,13,9,4,2016,22,11,11,13,5,8,14,NA
"3516","AL","506","Tuscaloosa City & County CoC",177,47,130,72,14,58,21,5,16,2016,13,0,13,19,17,2,0,NA
"3517","AL","507","Alabama Balance of State CoC",827,459,368,212,106,106,69,37,32,2016,44,5,39,28,9,19,2,NA
"3518","AR","500","Little Rock/Central Arkansas CoC",808,469,339,66,61,5,22,20,2,2016,208,66,142,121,84,37,3,NA
"3519","AR","501","Fayetteville/Northwest Arkansas CoC",550,489,61,191,187,4,47,45,2,2016,90,60,30,56,45,11,32,NA
"3520","AR","503","Arkansas  Balance of State  CoC",761,380,381,228,105,123,69,33,36,2016,101,26,75,25,14,11,0,NA
"3521","AR","504","Delta Hills CoC",89,89,0,62,62,0,31,31,0,2016,24,24,0,0,0,0,0,NA
"3522","AR","505","Southeast Arkansas CoC",89,78,11,43,38,5,13,12,1,2016,26,26,0,2,2,0,14,NA
"3523","AR","508","Fort Smith CoC",166,111,55,35,23,12,9,6,3,2016,54,24,30,18,14,4,0,NA
"3524","AR","512","Boone, Baxter, Marion, Newton Counties CoC",NA,NA,NA,NA,NA,NA,NA,NA,NA,2016,NA,NA,NA,NA,NA,NA,NA,NA
"3525","AZ","500","Arizona Balance of State CoC",2240,1023,1217,506,365,141,154,117,37,2016,437,43,394,305,112,193,18,NA
"3526","AZ","501","Tucson/Pima County CoC",1765,1384,381,460,458,2,139,138,1,2016,213,93,120,281,232,49,16,NA
"3527","AZ","502","Phoenix, Mesa/Maricopa County CoC",5702,4056,1646,2082,2076,6,624,622,2,2016,745,332,413,450,319,131,66,NA
"3528","CA","500","San Jose/Santa Clara City & County CoC",6524,1897,4627,939,876,63,276,259,17,2016,2146,128,2018,701,255,446,50,NA
"3529","CA","501","San Francisco CoC",6996,2638,4358,687,654,33,201,190,11,2016,1932,718,1214,580,228,352,131,NA
"3530","CA","502","Oakland, Berkeley/Alameda County CoC",4145,1748,2397,997,753,244,316,269,47,2016,753,214,539,401,170,231,11,NA
"3531","CA","503","Sacramento City & County CoC",2500,1552,948,579,542,37,194,183,11,2016,540,222,318,308,166,142,6,NA
"3532","CA","504","Santa Rosa, Petaluma/Sonoma County CoC",2906,1000,1906,389,369,20,156,149,7,2016,747,192,555,274,54,220,98,NA
"3533","CA","505","Richmond/Contra Costa County CoC",1730,620,1110,364,235,129,111,73,38,2016,384,164,220,136,51,85,6,NA
"3534","CA","506","Salinas/Monterey, San Benito Counties CoC",3022,915,2107,486,473,13,150,146,4,2016,660,98,562,204,83,121,46,NA
"3535","CA","507","Marin County CoC",1258,423,835,188,179,9,57,55,2,2016,257,24,233,78,37,41,6,NA
"3536","CA","508","Watsonville/Santa Cruz City & County CoC",1959,605,1354,505,299,206,147,96,51,2016,573,156,417,146,33,113,32,NA
"3537","CA","509","Mendocino County CoC",1242,192,1050,95,52,43,35,16,19,2016,177,76,101,19,5,14,0,NA
"3538","CA","510","Turlock, Modesto/Stanislaus County CoC",1434,704,730,287,219,68,92,69,23,2016,361,114,247,74,39,35,10,NA
"3539","CA","511","Stockton/San Joaquin County CoC",1780,1245,535,833,785,48,242,227,15,2016,247,37,210,138,77,61,4,NA
"3540","CA","512","Daly/San Mateo County CoC",1361,586,775,450,335,115,132,97,35,2016,238,5,233,136,46,90,4,NA
"3541","CA","513","Visalia/Kings, Tulare Counties CoC",792,326,466,146,127,19,45,39,6,2016,251,20,231,37,4,33,0,NA
"3542","CA","514","Fresno City & County/Madera County CoC",1883,452,1431,199,176,23,62,56,6,2016,546,18,528,228,84,144,2,NA
"3543","CA","515","Roseville, Rocklin/Placer, Nevada Counties CoC",1021,522,499,160,85,75,49,25,24,2016,347,110,237,67,24,43,1,NA
"3544","CA","516","Redding/Shasta, Siskiyou, Lassen, Plumas, Del Norte, Modoc, Sierra Counties CoC",1272,312,960,207,88,119,59,30,29,2016,425,57,368,98,32,66,7,NA
"3545","CA","517","Napa City & County CoC",317,199,118,82,72,10,21,19,2,2016,98,57,41,22,8,14,0,NA
"3546","CA","518","Vallejo/Solano County CoC",1118,323,795,163,146,17,53,47,6,2016,259,41,218,119,54,65,9,NA
"3547","CA","519","Chico, Paradise/Butte County CoC",574,289,285,134,132,2,32,31,1,2016,251,45,206,49,22,27,4,NA
"3548","CA","520","Merced City & County CoC",516,160,356,12,4,8,4,1,3,2016,224,27,197,25,5,20,3,NA
"3549","CA","521","Davis, Woodland/Yolo County CoC",532,339,193,210,200,10,68,65,3,2016,89,45,44,29,13,16,4,NA
"3550","CA","522","Humboldt County CoC",1134,198,936,145,98,47,55,35,20,2016,377,0,377,131,39,92,22,NA
"3551","CA","523","Colusa, Glenn, Trinity Counties CoC",115,35,80,44,31,13,14,10,4,2016,33,3,30,7,0,7,0,NA
"3552","CA","524","Yuba City & County/Sutter County CoC",702,191,511,315,116,199,93,35,58,2016,233,35,198,21,1,20,23,NA
"3553","CA","525","El Dorado County CoC",269,121,148,77,21,56,25,7,18,2016,139,48,91,17,6,11,6,NA
"3554","CA","526","Amador, Calaveras, Mariposa, Tuolumne Counties CoC",632,151,481,123,84,39,37,26,11,2016,129,3,126,35,14,21,0,NA
"3555","CA","527","Tehama County CoC",133,73,60,30,25,5,9,8,1,2016,31,8,23,16,8,8,0,NA
"3556","CA","529","Lake County CoC",332,44,288,122,42,80,42,15,27,2016,24,24,0,21,0,21,1,NA
"3557","CA","530","Alpine, Inyo, Mono Counties CoC",130,11,119,20,10,10,5,2,3,2016,33,0,33,8,0,8,0,NA
"3558","CA","600","Los Angeles City & County CoC",43854,11073,32781,6128,4297,1831,2296,1441,855,2016,13468,660,12808,2728,1243,1485,125,NA
"3559","CA","601","San Diego City and County CoC",8669,3729,4940,1714,1432,282,545,469,76,2016,1417,309,1108,1156,584,572,145,NA
"3560","CA","602","Santa Ana, Anaheim/Orange County CoC",4319,2118,2201,1291,1285,6,413,411,2,2016,716,269,447,455,99,356,14,NA
"3561","CA","603","Santa Maria/Santa Barbara County CoC",1813,923,890,428,346,82,126,103,23,2016,453,122,331,122,43,79,9,NA
"3562","CA","604","Bakersfield/Kern County CoC",1067,561,506,192,180,12,71,65,6,2016,272,65,207,99,65,34,0,NA
"3563","CA","606","Long Beach CoC",2250,737,1513,342,190,152,105,62,43,2016,838,89,749,289,195,94,1,NA
"3564","CA","607","Pasadena CoC",530,178,352,77,74,3,26,25,1,2016,201,47,154,44,13,31,1,NA
"3565","CA","608","Riverside City & County CoC",2165,814,1351,265,235,30,74,64,10,2016,378,77,301,211,111,100,17,NA
"3566","CA","609","San Bernardino City & County CoC",1887,696,1191,465,399,66,152,130,22,2016,405,20,385,122,29,93,25,NA
"3567","CA","611","Oxnard, San Buenaventura/Ventura County CoC",1271,494,777,260,131,129,62,40,22,2016,303,42,261,78,21,57,10,NA
"3568","CA","612","Glendale CoC",240,185,55,64,52,12,24,19,5,2016,115,80,35,10,2,8,0,NA
"3569","CA","613","Imperial County CoC",380,128,252,100,100,0,40,40,0,2016,60,0,60,12,1,11,0,NA
"3570","CA","614","San Luis Obispo County CoC",1368,245,1123,168,83,85,48,26,22,2016,418,9,409,161,48,113,14,NA
"3571","CO","500","Colorado Balance of State CoC",3520,1689,1831,1514,769,745,451,238,213,2016,703,182,521,291,133,158,4,NA
"3572","CO","503","Metropolitan Denver CoC",5728,4931,797,2147,2070,77,627,604,23,2016,739,528,211,722,649,73,34,NA
"3573","CO","504","Colorado Springs/El Paso County CoC",1302,991,311,439,420,19,122,117,5,2016,387,239,148,168,124,44,1,NA
"3574","CT","503","Bridgeport, Stamford, Norwalk/Fairfield County CoC",886,730,156,361,361,0,120,120,0,2016,98,56,42,53,42,11,7,NA
"3575","CT","505","Connecticut Balance of State CoC",3016,2499,517,971,965,6,329,327,2,2016,369,226,143,163,131,32,1,NA
"3576","DE","500","Delaware Statewide CoC",1070,1019,51,317,317,0,108,108,0,2016,74,72,2,107,103,4,0,NA
"3577","FL","500","Sarasota, Bradenton/Manatee, Sarasota Counties CoC",1468,804,664,249,197,52,79,66,13,2016,311,42,269,161,99,62,20,NA
"3578","FL","501","Tampa/Hillsborough County CoC",1817,1048,769,533,471,62,166,151,15,2016,254,61,193,181,112,69,3,NA
"3579","FL","502","St. Petersburg, Clearwater, Largo/Pinellas County CoC",2777,1638,1139,394,375,19,143,137,6,2016,607,141,466,380,269,111,34,NA
"3580","FL","503","Lakeland, Winterhaven/Polk County CoC",635,375,260,218,174,44,56,47,9,2016,88,20,68,42,20,22,3,NA
"3581","FL","504","Daytona Beach, Daytona/Volusia, Flagler Counties CoC",1005,424,581,256,212,44,91,76,15,2016,210,13,197,36,23,13,11,NA
"3582","FL","505","Fort Walton Beach/Okaloosa, Walton Counties CoC",629,272,357,108,103,5,39,37,2,2016,306,63,243,37,10,27,39,NA
"3583","FL","506","Tallahassee/Leon County CoC",869,721,148,234,230,4,68,67,1,2016,81,59,22,117,88,29,14,NA
"3584","FL","507","Orlando/Orange, Osceola, Seminole Counties CoC",1670,1537,133,576,576,0,187,187,0,2016,106,82,24,231,225,6,0,NA
"3585","FL","508","Gainesville/Alachua, Putnam Counties CoC",844,419,425,248,246,2,87,86,1,2016,265,43,222,123,47,76,22,NA
"3586","FL","509","Fort Pierce/St. Lucie, Indian River, Martin Counties CoC",2382,248,2134,1457,186,1271,492,53,439,2016,77,0,77,50,3,47,8,NA
"3587","FL","510","Jacksonville-Duval, Clay Counties CoC",1959,1518,441,493,493,0,164,164,0,2016,337,193,144,130,104,26,22,NA
"3588","FL","511","Pensacola/Escambia, Santa Rosa Counties CoC",798,616,182,183,172,11,57,53,4,2016,216,156,60,112,86,26,11,NA
"3589","FL","512","St. Johns County CoC",1064,255,809,283,180,103,71,49,22,2016,35,6,29,36,9,27,8,NA
"3590","FL","513","Palm Bay, Melbourne/Brevard County CoC",827,644,183,322,292,30,99,84,15,2016,193,43,150,160,147,13,30,NA
"3591","FL","514","Ocala/Marion County CoC",823,295,528,173,97,76,66,40,26,2016,65,0,65,108,73,35,7,NA
"3592","FL","515","Panama City/Bay, Jackson Counties CoC",310,174,136,44,35,9,17,14,3,2016,30,10,20,39,10,29,7,NA
"3593","FL","517","Hendry, Hardee, Highlands Counties CoC",1071,313,758,470,187,283,157,62,95,2016,335,37,298,12,12,0,50,NA
"3594","FL","518","Columbia, Hamilton, Lafayette, Suwannee Counties CoC",1145,96,1049,260,42,218,77,14,63,2016,216,7,209,140,28,112,13,NA
"3595","FL","519","Pasco County CoC",1055,195,860,262,82,180,106,34,72,2016,404,13,391,100,30,70,127,NA
"3596","FL","520","Citrus, Hernando, Lake, Sumter Counties CoC",595,303,292,181,146,35,58,48,10,2016,33,10,23,49,30,19,0,NA
"3597","FL","600","Miami-Dade County CoC",4235,3253,982,1053,1051,2,316,315,1,2016,472,135,337,157,126,31,46,NA
"3598","FL","601","Ft Lauderdale/Broward County CoC",2302,1520,782,458,435,23,148,139,9,2016,430,150,280,210,129,81,14,NA
"3599","FL","602","Punta Gorda/Charlotte County CoC",388,134,254,165,55,110,55,15,40,2016,76,10,66,65,55,10,0,NA
"3600","FL","603","Ft Myers, Cape Coral/Lee County CoC",439,256,183,129,94,35,37,30,7,2016,90,20,70,19,12,7,10,NA
"3601","FL","604","Monroe County CoC",575,305,270,78,46,32,23,14,9,2016,126,8,118,87,45,42,5,NA
"3602","FL","605","West Palm Beach/Palm Beach County CoC",1332,507,825,324,271,53,104,87,17,2016,459,31,428,115,29,86,2,NA
"3603","FL","606","Naples/Collier County CoC",545,328,217,207,109,98,68,33,35,2016,73,49,24,5,4,1,8,NA
"3604","GA","500","Atlanta CoC",4063,3225,838,453,394,59,141,122,19,2016,556,290,266,369,366,3,5,NA
"3605","GA","501","Georgia Balance of State CoC",5575,2057,3518,2183,1397,786,678,485,193,2016,883,50,833,468,48,420,5,NA
"3606","GA","502","Fulton County CoC",483,422,61,201,194,7,66,64,2,2016,28,28,0,57,57,0,0,NA
"3607","GA","503","Athens-Clarke County CoC",224,148,76,68,59,9,21,18,3,2016,49,19,30,14,8,6,0,NA
"3608","GA","504","Augusta-Richmond County CoC",287,266,21,95,92,3,31,30,1,2016,42,29,13,48,46,2,0,NA
"3609","GA","505","Columbus-Muscogee/Russell County CoC",329,243,86,57,57,0,16,16,0,2016,35,12,23,17,11,6,0,NA
"3610","GA","506","Marietta/Cobb County CoC",405,314,91,200,178,22,68,61,7,2016,43,2,41,21,9,12,0,NA
"3611","GA","507","Savannah/Chatham County CoC",1070,553,517,147,147,0,48,48,0,2016,155,35,120,29,17,12,7,NA
"3612","GA","508","DeKalb County CoC",473,315,158,240,240,0,76,76,0,2016,24,5,19,32,19,13,0,NA
"3613","HI","500","Hawaii Balance of State CoC",2981,846,2135,1188,487,701,292,133,159,2016,859,16,843,257,40,217,3,NA
"3614","HI","501","Honolulu City and County CoC",4940,2767,2173,2143,1844,299,513,436,77,2016,1090,121,969,413,224,189,23,NA
"3615","IA","500","Sioux City/Dakota, Woodbury Counties CoC",348,339,9,185,185,0,55,55,0,2016,17,13,4,15,15,0,0,NA
"3616","IA","501","Iowa Balance of State CoC",1923,1858,65,1101,1101,0,334,334,0,2016,101,88,13,58,55,3,17,NA
"3617","IA","502","Des Moines/Polk County CoC",793,724,69,235,235,0,77,77,0,2016,66,36,30,97,84,13,1,NA
"3618","ID","500","Boise/Ada County CoC",867,742,125,187,174,13,56,53,3,2016,140,96,44,157,138,19,8,NA
"3619","ID","501","Idaho Balance of State CoC",1380,767,613,776,449,327,235,144,91,2016,197,64,133,110,64,46,8,NA
"3620","IL","500","McHenry County CoC",154,150,4,52,52,0,16,16,0,2016,7,7,0,24,24,0,0,NA
"3621","IL","501","Rockford/Winnebago, Boone Counties CoC",255,207,48,80,80,0,23,23,0,2016,47,38,9,13,6,7,0,NA
"3622","IL","502","Waukegan, North Chicago/Lake County CoC",299,280,19,156,156,0,47,47,0,2016,32,27,5,11,9,2,0,NA
"3623","IL","503","Champaign, Urbana, Rantoul/Champaign County CoC",188,170,18,64,62,2,23,22,1,2016,5,0,5,10,8,2,2,NA
"3624","IL","504","Madison County CoC",199,176,23,148,142,6,41,40,1,2016,23,5,18,7,6,1,0,NA
"3625","IL","506","Joliet, Bolingbrook/Will County CoC",290,242,48,95,88,7,27,26,1,2016,17,3,14,23,20,3,0,NA
"3626","IL","507","Peoria, Pekin/Fulton, Tazewell, Peoria, Woodford Counties CoC",378,308,70,107,96,11,36,33,3,2016,92,67,25,12,11,1,0,NA
"3627","IL","508","East St. Louis, Belleville/St. Clair County CoC",240,157,83,108,91,17,37,32,5,2016,41,15,26,34,29,5,0,NA
"3628","IL","509","Dekalb City & County CoC",81,77,4,38,38,0,12,12,0,2016,0,0,0,2,2,0,0,NA
"3629","IL","510","Chicago CoC",5889,4646,1243,2168,2158,10,663,661,2,2016,343,110,233,601,399,202,4,NA
"3630","IL","511","Cook County CoC",952,842,110,396,396,0,136,136,0,2016,128,103,25,81,74,7,1,NA
"3631","IL","512","Bloomington/Central Illinois CoC",411,363,48,196,167,29,61,48,13,2016,83,71,12,25,23,2,0,NA
"3632","IL","513","Springfield/Sangamon County CoC",261,246,15,85,85,0,27,27,0,2016,38,25,13,22,21,1,3,NA
"3633","IL","514","DuPage County CoC",555,525,30,351,351,0,117,117,0,2016,37,33,4,14,13,1,8,NA
"3634","IL","515","South Central Illinois CoC",133,121,12,89,89,0,27,27,0,2016,5,5,0,1,1,0,0,NA
"3635","IL","516","Decatur/Macon County CoC",157,150,7,47,47,0,18,18,0,2016,23,21,2,12,12,0,0,NA
"3636","IL","517","Aurora, Elgin/Kane County CoC",355,341,14,86,86,0,31,31,0,2016,76,67,9,17,16,1,0,NA
"3637","IL","518","Rock Island, Moline/Northwestern Illinois CoC",340,301,39,132,123,9,43,40,3,2016,0,0,0,14,14,0,6,NA
"3638","IL","519","West Central Illinois CoC",102,102,0,30,30,0,10,10,0,2016,3,3,0,5,5,0,0,NA
"3639","IL","520","Southern Illinois CoC",351,332,19,176,173,3,66,65,1,2016,24,20,4,21,20,1,4,NA
"3640","IN","502","Indiana Balance of State CoC",4179,3618,561,1517,1492,25,472,467,5,2016,427,264,163,337,297,40,33,NA
"3641","IN","503","Indianapolis CoC",1619,1489,130,457,457,0,137,137,0,2016,162,110,52,326,317,9,4,NA
"3642","KS","502","Wichita/Sedgwick County CoC",571,492,79,193,189,4,59,58,1,2016,39,15,24,46,31,15,2,NA
"3643","KS","503","Topeka/Shawnee County CoC",381,334,47,109,109,0,31,31,0,2016,194,181,13,40,31,9,0,NA
"3644","KS","505","Overland Park, Shawnee/Johnson County CoC",153,143,10,124,124,0,42,42,0,2016,0,0,0,2,2,0,1,NA
"3645","KS","507","Kansas Balance of State CoC",903,807,96,507,501,6,183,181,2,2016,85,45,40,41,40,1,9,NA
"3646","KY","500","Kentucky Balance of State CoC",2057,1484,573,817,662,155,251,207,44,2016,93,31,62,164,130,34,8,NA
"3647","KY","501","Louisville-Jefferson County CoC",1116,1004,112,305,303,2,100,99,1,2016,186,111,75,191,167,24,5,NA
"3648","KY","502","Lexington-Fayette County CoC",1064,1043,21,166,166,0,59,59,0,2016,103,93,10,157,155,2,8,NA
"3649","LA","500","Lafayette/Acadiana CoC",463,350,113,164,164,0,48,48,0,2016,62,13,49,38,27,11,0,NA
"3650","LA","502","Shreveport, Bossier/Northwest Louisiana CoC",478,413,65,110,110,0,38,38,0,2016,17,7,10,105,105,0,2,NA
"3651","LA","503","New Orleans/Jefferson Parish CoC",1626,909,717,188,178,10,61,57,4,2016,403,118,285,92,85,7,9,NA
"3652","LA","505","Monroe/Northeast Louisiana CoC",188,175,13,101,101,0,21,21,0,2016,8,5,3,6,5,1,5,NA
"3653","LA","506","Slidell/Southeast Louisiana CoC",275,215,60,67,59,8,21,18,3,2016,24,9,15,39,33,6,0,NA
"3654","LA","507","Alexandria/Central Louisiana CoC",167,113,54,38,38,0,10,10,0,2016,7,2,5,33,27,6,0,NA
"3655","LA","509","Louisiana Balance of State CoC",797,678,119,150,134,16,44,39,5,2016,49,13,36,87,81,6,47,NA
"3656","MA","500","Boston CoC",6240,6073,167,3755,3755,0,1358,1358,0,2016,919,900,19,222,217,5,4,NA
"3657","MA","502","Lynn CoC",541,537,4,428,428,0,124,124,0,2016,6,6,0,2,2,0,0,NA
"3658","MA","503","Cape Cod Islands CoC",394,327,67,180,178,2,67,66,1,2016,56,16,40,23,17,6,5,NA
"3659","MA","504","Springfield/Hampden County CoC",2385,2350,35,2006,2006,0,552,552,0,2016,170,154,16,25,25,0,1,NA
"3660","MA","505","New Bedford CoC",469,414,55,169,169,0,51,51,0,2016,56,36,20,61,56,5,4,NA
"3661","MA","506","Worcester City & County CoC",1572,1506,66,1044,1044,0,311,311,0,2016,65,51,14,160,159,1,0,NA
"3662","MA","507","Pittsfield/Berkshire, Franklin, Hampshire Counties CoC",653,625,28,198,198,0,57,57,0,2016,80,68,12,266,265,1,0,NA
"3663","MA","508","Lowell CoC",594,575,19,384,384,0,134,134,0,2016,63,63,0,36,36,0,0,NA
"3664","MA","509","Cambridge CoC",517,448,69,118,118,0,46,46,0,2016,129,60,69,7,7,0,0,NA
"3665","MA","510","Gloucester, Haverhill, Salem/Essex County CoC",1206,1145,61,966,964,2,408,407,1,2016,99,82,17,31,28,3,0,NA
"3666","MA","511","Quincy, Brockton, Weymouth, Plymouth City and County CoC",1692,1654,38,1293,1293,0,432,432,0,2016,270,254,16,60,59,1,0,NA
"3667","MA","515","Fall River CoC",386,379,7,259,259,0,76,76,0,2016,60,59,1,5,1,4,0,NA
"3668","MA","516","Massachusetts Balance of State CoC",2551,2440,111,2122,2110,12,691,686,5,2016,300,291,9,17,14,3,1,NA
"3669","MA","517","Somerville CoC",165,159,6,65,65,0,19,19,0,2016,22,16,6,28,28,0,0,NA
"3670","MA","519","Attleboro, Taunton/Bristol County CoC",243,216,27,187,187,0,55,55,0,2016,30,18,12,6,1,5,0,NA
"3671","MD","500","Cumberland/Allegany County CoC",124,84,40,48,45,3,14,13,1,2016,12,4,8,1,1,0,0,NA
"3672","MD","501","Baltimore CoC",2725,2388,337,698,698,0,225,225,0,2016,605,437,168,269,234,35,6,NA
"3673","MD","502","Harford County CoC",179,169,10,84,84,0,28,28,0,2016,14,11,3,9,9,0,0,NA
"3674","MD","503","Annapolis/Anne Arundel County CoC",390,338,52,165,160,5,51,50,1,2016,70,43,27,28,23,5,0,NA
"3675","MD","504","Howard County CoC",214,205,9,102,100,2,30,29,1,2016,47,41,6,7,6,1,0,NA
"3676","MD","505","Baltimore County CoC",763,448,315,380,234,146,121,76,45,2016,108,30,78,41,17,24,0,NA
"3677","MD","506","Carroll County CoC",136,136,0,66,66,0,22,22,0,2016,10,10,0,3,3,0,0,NA
"3678","MD","507","Cecil County CoC",167,116,51,68,62,6,24,22,2,2016,30,4,26,44,37,7,0,NA
"3679","MD","508","Charles, Calvert, St.Mary's Counties CoC",464,213,251,174,65,109,52,23,29,2016,81,44,37,26,9,17,6,NA
"3680","MD","509","Frederick City & County CoC",349,220,129,100,100,0,32,32,0,2016,133,56,77,12,8,4,0,NA
"3681","MD","510","Garrett County CoC",20,20,0,10,10,0,4,4,0,2016,0,0,0,0,0,0,0,NA
"3682","MD","511","Mid-Shore Regional CoC",138,112,26,50,44,6,13,11,2,2016,23,18,5,7,4,3,0,NA
"3683","MD","512","Hagerstown/Washington County CoC",233,160,73,46,33,13,17,12,5,2016,27,15,12,46,37,9,0,NA
"3684","MD","513","Wicomico, Somerset, Worcester Counties CoC",262,225,37,49,47,2,19,18,1,2016,33,17,16,19,17,2,0,NA
"3685","MD","600","Prince George's County CoC",544,442,102,308,304,4,105,103,2,2016,20,7,13,26,19,7,3,NA
"3686","MD","601","Montgomery County CoC",981,885,96,358,358,0,109,109,0,2016,151,107,44,17,12,5,0,NA
"3687","ME","500","Maine Statewide CoC",2241,2121,120,920,906,14,297,292,5,2016,217,174,43,146,125,21,31,NA
"3688","MI","500","Michigan Balance of State CoC",1466,1244,222,651,618,33,204,194,10,2016,43,24,19,66,48,18,25,NA
"3689","MI","501","Detroit CoC",2335,2142,193,641,634,7,220,217,3,2016,329,226,103,354,336,18,4,NA
"3690","MI","502","Dearborn, Dearborn Heights, Westland/Wayne County CoC",277,266,11,145,145,0,45,45,0,2016,9,8,1,17,16,1,4,NA
"3691","MI","503","St. Clair Shores, Warren/Macomb County CoC",403,354,49,86,86,0,30,30,0,2016,14,10,4,55,55,0,3,NA
"3692","MI","504","Pontiac, Royal Oak/Oakland County CoC",438,362,76,166,166,0,54,54,0,2016,37,34,3,8,6,2,4,NA
"3693","MI","505","Flint/Genesee County CoC",377,290,87,153,141,12,45,43,2,2016,24,16,8,20,16,4,3,NA
"3694","MI","506","Grand Rapids, Wyoming/Kent County CoC",800,759,41,273,273,0,83,83,0,2016,63,59,4,76,71,5,11,NA
"3695","MI","507","Portage, Kalamazoo City & County CoC",374,366,8,212,212,0,71,71,0,2016,18,18,0,14,14,0,8,NA
"3696","MI","508","Lansing, East Lansing/Ingham County CoC",471,355,116,168,117,51,49,36,13,2016,44,34,10,54,43,11,6,NA
"3697","MI","509","Washtenaw County CoC",342,301,41,79,79,0,23,23,0,2016,63,47,16,41,41,0,1,NA
"3698","MI","510","Saginaw City & County CoC",343,326,17,153,146,7,41,39,2,2016,22,19,3,19,18,1,5,NA
"3699","MI","511","Lenawee County CoC",137,119,18,86,72,14,28,24,4,2016,16,13,3,2,2,0,3,NA
"3700","MI","512","Grand Traverse, Antrim, Leelanau Counties CoC",243,233,10,39,39,0,12,12,0,2016,38,36,2,14,14,0,15,NA
"3701","MI","513","Marquette, Alger Counties CoC",70,68,2,44,44,0,15,15,0,2016,1,0,1,2,2,0,0,NA
"3702","MI","514","Battle Creek/Calhoun County CoC",246,209,37,75,75,0,25,25,0,2016,25,17,8,33,29,4,0,NA
"3703","MI","515","Monroe City & County CoC",176,173,3,45,45,0,14,14,0,2016,11,10,1,27,27,0,7,NA
"3704","MI","516","Norton Shores, Muskegon City & County CoC",191,184,7,87,87,0,26,26,0,2016,5,1,4,4,4,0,1,NA
"3705","MI","517","Jackson City & County CoC",169,162,7,112,109,3,35,34,1,2016,2,1,1,5,5,0,0,NA
"3706","MI","518","Livingston County CoC",77,75,2,38,38,0,11,11,0,2016,1,0,1,2,2,0,2,NA
"3707","MI","519","Holland/Ottawa County CoC",261,257,4,151,151,0,46,46,0,2016,9,6,3,8,8,0,0,NA
"3708","MI","523","Eaton County CoC",120,111,9,109,106,3,32,31,1,2016,2,0,2,1,1,0,0,NA
"3709","MN","500","Minneapolis/Hennepin County CoC",3056,2886,170,1591,1591,0,412,412,0,2016,390,332,58,137,126,11,21,NA
"3710","MN","501","Saint Paul/Ramsey County CoC",1346,1210,136,544,535,9,180,177,3,2016,210,179,31,48,47,1,17,NA
"3711","MN","502","Rochester/Southeast Minnesota CoC",423,409,14,276,276,0,83,83,0,2016,35,28,7,9,6,3,0,NA
"3712","MN","503","Dakota, Anoka, Washington, Scott, Carver Counties",618,411,207,329,276,53,88,76,12,2016,57,48,9,19,16,3,14,NA
"3713","MN","504","Northeast Minnesota CoC",77,60,17,40,32,8,9,8,1,2016,2,1,1,0,0,0,0,NA
"3714","MN","505","St. Cloud/Central Minnesota CoC",669,502,167,320,274,46,113,100,13,2016,18,12,6,25,24,1,10,NA
"3715","MN","506","Northwest Minnesota CoC",290,288,2,179,179,0,56,56,0,2016,22,22,0,6,6,0,12,NA
"3716","MN","508","Moorhead/West Central Minnesota CoC",211,199,12,107,107,0,34,34,0,2016,24,21,3,8,7,1,2,NA
"3717","MN","509","Duluth/St.Louis County CoC",528,370,158,198,192,6,65,63,2,2016,110,70,40,21,13,8,11,NA
"3718","MN","511","Southwest Minnesota CoC",123,117,6,88,88,0,25,25,0,2016,5,5,0,6,3,3,2,NA
"3719","MO","500","St. Louis County CoC",465,417,48,209,205,4,77,76,1,2016,18,8,10,51,49,2,108,NA
"3720","MO","501","St.Louis City CoC",1248,1150,98,460,460,0,146,146,0,2016,168,132,36,140,137,3,1,NA
"3721","MO","503","St. Charles City & County, Lincoln, Warren Counties CoC",610,380,230,322,232,90,77,59,18,2016,33,7,26,9,2,7,5,NA
"3722","MO","600","Springfield/Greene, Christian, Webster Counties CoC",496,284,212,195,171,24,65,58,7,2016,221,37,184,29,7,22,4,NA
"3723","MO","602","Joplin/Jasper, Newton Counties CoC",297,238,59,82,79,3,28,27,1,2016,19,19,0,54,51,3,4,NA
"3724","MO","603","St. Joseph/Andrew, Buchanan, DeKalb Counties CoC",195,185,10,87,87,0,28,28,0,2016,45,41,4,20,18,2,0,NA
"3725","MO","604a","Kansas City, Independence, Lee’s Summit/Jackson, Wyandotte Counties, MO & KS",1699,1465,234,529,519,10,170,167,3,2016,475,397,78,197,176,21,50,NA
"3726","MO","606","Missouri Balance of State CoC",1431,1056,375,594,489,105,204,170,34,2016,201,137,64,115,88,27,36,NA
"3727","MS","500","Jackson/Rankin, Madison Counties CoC",633,297,336,67,67,0,21,21,0,2016,88,2,86,65,17,48,10,NA
"3728","MS","501","Mississippi Balance of State CoC",785,479,306,301,203,98,88,59,29,2016,57,17,40,66,37,29,0,NA
"3729","MS","503","Gulf Port/Gulf Coast Regional CoC",320,113,207,71,63,8,24,21,3,2016,38,9,29,13,4,9,0,NA
"3730","MT","500","Montana Statewide CoC",1418,788,630,574,345,229,172,113,59,2016,137,26,111,165,92,73,13,NA
"3731","NC","500","Winston-Salem/Forsyth County CoC",544,506,38,144,144,0,49,49,0,2016,95,78,17,67,61,6,0,NA
"3732","NC","501","Asheville/Buncombe County CoC",509,437,72,37,37,0,16,16,0,2016,74,34,40,196,192,4,5,NA
"3733","NC","502","Durham City & County CoC",354,322,32,117,117,0,33,33,0,2016,57,48,9,71,70,1,0,NA
"3734","NC","503","North Carolina Balance of State CoC",2963,2128,835,1112,835,277,342,266,76,2016,348,165,183,136,82,54,15,NA
"3735","NC","504","Greensboro, High Point CoC",721,637,84,177,177,0,56,56,0,2016,38,23,15,66,66,0,15,NA
"3736","NC","505","Charlotte/Mecklenberg CoC",1818,1631,187,650,647,3,226,225,1,2016,191,128,63,149,124,25,8,NA
"3737","NC","506","Wilmington/Brunswick, New Hanover, Pender Counties CoC",389,261,128,99,92,7,31,29,2,2016,81,21,60,52,33,19,5,NA
"3738","NC","507","Raleigh/Wake County CoC",818,680,138,249,247,2,85,84,1,2016,149,113,36,78,62,16,3,NA
"3739","NC","509","Gastonia/Cleveland, Gaston, Lincoln Counties CoC",328,243,85,90,72,18,28,23,5,2016,36,14,22,16,13,3,14,NA
"3740","NC","511","Fayetteville/Cumberland County CoC",515,224,291,174,143,31,50,41,9,2016,80,1,79,43,18,25,0,NA
"3741","NC","513","Chapel Hill/Orange County CoC",80,65,15,10,10,0,4,4,0,2016,16,2,14,7,5,2,0,NA
"3742","NC","516","Northwest North Carolina CoC",520,116,404,304,47,257,121,19,102,2016,19,11,8,7,4,3,0,NA
"3743","ND","500","North Dakota Statewide CoC",923,707,216,261,198,63,70,58,12,2016,120,41,79,116,63,53,10,NA
"3744","NE","500","Nebraska Balance of State CoC",551,539,12,267,267,0,89,89,0,2016,7,6,1,13,12,1,12,NA
"3745","NE","501","Omaha, Council Bluffs CoC",1509,1452,57,399,399,0,128,128,0,2016,200,168,32,134,128,6,8,NA
"3746","NE","502","Lincoln CoC",694,662,32,208,208,0,63,63,0,2016,26,22,4,72,71,1,20,NA
"3747","NH","500","New Hampshire Balance of State CoC",670,594,76,227,223,4,85,83,2,2016,213,173,40,25,23,2,1,NA
"3748","NH","501","Manchester CoC",400,346,54,198,196,2,72,71,1,2016,56,37,19,35,33,2,0,NA
"3749","NH","502","Nashua/Hillsborough County CoC",296,283,13,114,109,5,28,27,1,2016,12,6,6,63,63,0,0,NA
"3750","NJ","500","Atlantic City & County CoC",476,360,116,36,36,0,14,14,0,2016,53,22,31,59,54,5,0,NA
"3751","NJ","501","Bergen County CoC",296,285,11,111,111,0,39,39,0,2016,10,5,5,10,10,0,5,NA
"3752","NJ","502","Burlington County CoC",926,913,13,455,455,0,143,143,0,2016,133,133,0,11,11,0,0,NA
"3753","NJ","503","Camden City & County/Gloucester, Cape May, Cumberland Counties CoC",1068,829,239,335,308,27,102,94,8,2016,75,23,52,151,135,16,1,NA
"3754","NJ","504","Newark/Essex County CoC",1779,1336,443,608,598,10,212,209,3,2016,97,8,89,52,32,20,14,NA
"3755","NJ","506","Jersey City, Bayonne/Hudson County CoC",829,603,226,245,243,2,87,86,1,2016,137,14,123,30,18,12,0,NA
"3756","NJ","507","New Brunswick/Middlesex County CoC",457,373,84,228,215,13,73,70,3,2016,44,19,25,14,10,4,0,NA
"3757","NJ","508","Monmouth County CoC",344,299,45,157,147,10,57,53,4,2016,74,41,33,17,13,4,0,NA
"3758","NJ","509","Morris County CoC",410,376,34,165,162,3,54,53,1,2016,34,24,10,15,14,1,0,NA
"3759","NJ","510","Lakewood Township/Ocean County CoC",429,375,54,255,255,0,78,78,0,2016,73,57,16,2,1,1,3,NA
"3760","NJ","511","Paterson/Passaic County CoC",432,396,36,241,238,3,81,80,1,2016,27,18,9,8,4,4,0,NA
"3761","NJ","513","Somerset County CoC",218,209,9,51,51,0,18,18,0,2016,1,1,0,92,90,2,8,NA
"3762","NJ","514","Trenton/Mercer County CoC",465,421,44,131,131,0,47,47,0,2016,20,2,18,15,13,2,3,NA
"3763","NJ","515","Elizabeth/Union County CoC",513,451,62,266,253,13,92,88,4,2016,19,10,9,7,7,0,0,NA
"3764","NJ","516","Warren, Sussex, Hunterdon Counties CoC",253,235,18,71,71,0,26,26,0,2016,25,22,3,73,73,0,0,NA
"3765","NM","500","Albuquerque CoC",1222,1039,183,355,346,9,108,106,2,2016,255,165,90,139,123,16,34,NA
"3766","NM","501","New Mexico Balance of State CoC",1041,770,271,352,336,16,121,117,4,2016,394,213,181,75,27,48,35,NA
"3767","NV","500","Las Vegas/Clark County CoC",6208,2477,3731,357,346,11,118,114,4,2016,285,32,253,730,328,402,279,NA
"3768","NV","501","Reno, Sparks/Washoe County CoC",989,869,120,112,112,0,38,38,0,2016,35,11,24,111,103,8,13,NA
"3769","NV","502","Nevada Balance of State CoC",201,125,76,76,76,0,24,24,0,2016,27,19,8,10,6,4,0,NA
"3770","NY","500","Rochester, Irondequoit, Greece/Monroe County CoC",860,791,69,319,314,5,110,108,2,2016,184,164,20,66,60,6,25,NA
"3771","NY","501","Elmira/Steuben, Allegany, Livingston, Chemung, Schuyler Counties CoC",506,380,126,176,139,37,61,47,14,2016,117,47,70,22,6,16,0,NA
"3772","NY","503","Albany City & County CoC",748,722,26,280,280,0,93,93,0,2016,83,63,20,71,69,2,10,NA
"3773","NY","504","Cattaragus County CoC",27,27,0,7,7,0,2,2,0,2016,1,1,0,1,1,0,1,NA
"3774","NY","505","Syracuse, Auburn/Onondaga, Oswego, Cayuga Counties CoC",867,840,27,262,255,7,95,93,2,2016,62,60,2,56,56,0,16,NA
"3775","NY","507","Schenectady City & County CoC",345,276,69,88,88,0,37,37,0,2016,31,26,5,13,11,2,16,NA
"3776","NY","508","Buffalo, Niagara Falls/Erie, Niagara, Orleans, Genesee, Wyoming Counties CoC",962,905,57,352,352,0,124,124,0,2016,38,23,15,97,88,9,26,NA
"3777","NY","510","Ithaca/Tompkins County CoC",86,56,30,20,20,0,8,8,0,2016,4,4,0,2,0,2,0,NA
"3778","NY","511","Binghamton, Union Town/Broome, Otsego, Chenango, Delaware, Cortland, Tioga Count",276,248,28,50,44,6,13,11,2,2016,0,0,0,2,2,0,9,NA
"3779","NY","512","Troy/Rensselaer County CoC",179,167,12,94,94,0,34,34,0,2016,19,18,1,3,3,0,1,NA
"3780","NY","513","Wayne, Ontario, Seneca, Yates Counties CoC",58,58,0,24,24,0,11,11,0,2016,33,33,0,1,1,0,4,NA
"3781","NY","514","Jamestown, Dunkirk/Chautauqua County CoC",23,23,0,7,7,0,2,2,0,2016,0,0,0,0,0,0,1,NA
"3782","NY","516","Clinton County CoC",132,130,2,38,38,0,12,12,0,2016,12,10,2,1,1,0,0,NA
"3783","NY","518","Utica, Rome/Oneida, Madison Counties CoC",160,143,17,54,54,0,21,21,0,2016,22,13,9,5,1,4,2,NA
"3784","NY","519","Columbia, Greene Counties CoC",116,114,2,64,64,0,22,22,0,2016,17,16,1,0,0,0,0,NA
"3785","NY","520","Franklin, Essex Counties CoC",27,25,2,7,5,2,2,1,1,2016,2,0,2,1,1,0,0,NA
"3786","NY","522","Jefferson, Lewis, St. Lawrence Counties CoC",119,110,9,23,23,0,9,9,0,2016,8,2,6,15,13,2,0,NA
"3787","NY","523","Glens Falls, Saratoga Springs/Saratoga, Washington, Warren, Hamilton Counties Co",268,252,16,75,75,0,33,33,0,2016,29,29,0,26,26,0,6,NA
"3788","NY","600","New York City CoC",73523,70685,2838,44558,44558,0,13483,13483,0,2016,4294,2481,1813,559,527,32,23,NA
"3789","NY","601","Poughkeepsie/Dutchess County CoC",385,363,22,167,161,6,60,59,1,2016,21,4,17,9,7,2,8,NA
"3790","NY","602","Newburgh, Middletown/Orange County CoC",343,323,20,158,158,0,50,50,0,2016,33,15,18,2,0,2,11,NA
"3791","NY","603","Nassau, Suffolk Counties CoC",3960,3845,115,2884,2882,2,777,776,1,2016,174,157,17,144,141,3,13,NA
"3792","NY","604","Yonkers, Mount Vernon/Westchester County CoC",1750,1716,34,1092,1092,0,362,362,0,2016,131,117,14,128,126,2,7,NA
"3793","NY","606","Rockland County CoC",141,109,32,17,17,0,7,7,0,2016,16,5,11,9,4,5,0,NA
"3794","NY","607","Sullivan County CoC",163,163,0,73,73,0,22,22,0,2016,3,3,0,2,2,0,1,NA
"3795","NY","608","Kingston/Ulster County CoC",328,290,38,148,144,4,49,47,2,2016,34,8,26,13,10,3,8,NA
"3796","OH","500","Cincinnati/Hamilton County CoC",1116,1056,60,272,272,0,80,80,0,2016,24,24,0,185,183,2,7,NA
"3797","OH","501","Toledo/Lucas County CoC",599,584,15,211,211,0,63,63,0,2016,31,31,0,30,29,1,1,NA
"3798","OH","502","Cleveland/Cuyahoga County CoC",1697,1623,74,337,337,0,111,111,0,2016,193,156,37,202,190,12,0,NA
"3799","OH","503","Columbus/Franklin County CoC",1724,1385,339,461,461,0,142,142,0,2016,160,44,116,133,103,30,7,NA
"3800","OH","504","Youngstown/Mahoning County CoC",346,308,38,129,118,11,43,40,3,2016,43,28,15,30,27,3,8,NA
"3801","OH","505","Dayton, Kettering/Montgomery County CoC",751,708,43,196,196,0,57,57,0,2016,56,42,14,60,59,1,2,NA
"3802","OH","506","Akron, Barberton/Summit County CoC",679,592,87,209,204,5,67,66,1,2016,45,9,36,67,61,6,19,NA
"3803","OH","507","Ohio Balance of State CoC",3032,2587,445,1357,1291,66,424,410,14,2016,182,78,104,207,179,28,2,NA
"3804","OH","508","Canton, Massillon, Alliance/Stark County CoC",460,423,37,286,286,0,92,92,0,2016,44,27,17,16,14,2,0,NA
"3805","OK","500","North Central Oklahoma CoC",129,78,51,56,48,8,18,16,2,2016,12,2,10,9,3,6,0,NA
"3806","OK","501","Tulsa City & County CoC",1043,893,150,277,260,17,84,78,6,2016,118,60,58,108,88,20,1,NA
"3807","OK","502","Oklahoma City CoC",1511,1204,307,309,309,0,92,92,0,2016,320,207,113,157,124,33,0,NA
"3808","OK","503","Oklahoma Balance of State CoC",295,114,181,142,78,64,55,33,22,2016,71,71,0,3,3,0,0,NA
"3809","OK","504","Norman/Cleveland County CoC",138,92,46,20,20,0,6,6,0,2016,60,14,46,12,6,6,0,NA
"3810","OK","505","Northeast Oklahoma CoC",368,342,26,131,120,11,44,40,4,2016,35,26,9,17,15,2,12,NA
"3811","OK","506","Southwest Oklahoma Regional CoC",187,147,40,84,81,3,29,28,1,2016,15,5,10,33,7,26,0,NA
"3812","OK","507","Southeastern Oklahoma Regional CoC",436,217,219,91,51,40,32,20,12,2016,65,20,45,19,14,5,26,NA
"3813","OR","500","Eugene, Springfield/Lane County CoC",1451,517,934,224,129,95,70,42,28,2016,574,86,488,162,52,110,13,NA
"3814","OR","501","Portland, Gresham/Multnomah County CoC",3914,2027,1887,705,547,158,226,179,47,2016,1053,178,875,420,224,196,4,NA
"3815","OR","502","Medford, Ashland/Jackson County CoC",527,288,239,80,54,26,31,21,10,2016,184,54,130,76,53,23,31,NA
"3816","OR","503","Central Oregon CoC",602,197,405,216,44,172,64,15,49,2016,218,9,209,62,20,42,5,NA
"3817","OR","505","Oregon Balance of State CoC",5710,1859,3851,2281,551,1730,817,168,649,2016,1078,214,864,525,207,318,179,NA
"3818","OR","506","Hillsboro, Beaverton/Washington County CoC",571,193,378,188,115,73,53,34,19,2016,142,11,131,63,47,16,3,NA
"3819","OR","507","Clackamas County CoC",463,155,308,165,138,27,54,47,7,2016,211,2,209,33,0,33,1,NA
"3820","PA","500","Philadelphia CoC",6112,5407,705,2682,2682,0,885,885,0,2016,853,451,402,293,276,17,20,NA
"3821","PA","501","Harrisburg/Dauphin County CoC",433,390,43,198,195,3,66,65,1,2016,42,28,14,50,44,6,0,NA
"3822","PA","502","Upper Darby, Chester, Haverford/Delaware County CoC",406,371,35,159,159,0,58,58,0,2016,26,12,14,8,8,0,0,NA
"3823","PA","503","Wilkes-Barre, Hazleton/Luzerne County CoC",169,160,9,60,60,0,23,23,0,2016,2,2,0,16,16,0,0,NA
"3824","PA","504","Lower Merion, Norristown, Abington/Montgomery County CoC",398,378,20,235,235,0,70,70,0,2016,17,13,4,9,7,2,0,NA
"3825","PA","505","Chester County CoC",558,553,5,173,173,0,55,55,0,2016,7,7,0,231,231,0,5,NA
"3826","PA","506","Reading/Berks County CoC",521,518,3,165,165,0,53,53,0,2016,19,19,0,29,29,0,0,NA
"3827","PA","508","Scranton/Lackawanna County CoC",242,231,11,126,126,0,42,42,0,2016,13,8,5,36,36,0,1,NA
"3828","PA","509","Eastern Pennsylvania CoC",2599,1996,603,1208,1087,121,387,350,37,2016,159,99,60,111,97,14,17,NA
"3829","PA","510","Lancaster City & County CoC",356,349,7,194,194,0,60,60,0,2016,6,5,1,17,17,0,0,NA
"3830","PA","511","Bristol, Bensalem/Bucks County CoC",530,500,30,330,325,5,107,105,2,2016,22,17,5,13,10,3,2,NA
"3831","PA","512","York City & County CoC",365,294,71,201,177,24,61,54,7,2016,14,9,5,13,13,0,16,NA
"3832","PA","600","Pittsburgh, McKeesport, Penn Hills/Allegheny County CoC",1156,1108,48,401,401,0,132,132,0,2016,94,74,20,167,164,3,0,NA
"3833","PA","601","Western Pennsylvania CoC",986,917,69,415,412,3,137,136,1,2016,32,27,5,119,118,1,0,NA
"3834","PA","603","Beaver County CoC",131,125,6,73,73,0,22,22,0,2016,8,5,3,1,0,1,0,NA
"3835","PA","605","Erie City & County CoC",377,367,10,120,120,0,42,42,0,2016,11,11,0,23,22,1,2,NA
"3836","RI","500","Rhode Island Statewide CoC",1160,1123,37,301,301,0,93,93,0,2016,144,141,3,89,89,0,0,NA
"3837","SC","500","Charleston/Low Country CoC",550,287,263,31,24,7,13,10,3,2016,142,54,88,142,112,30,0,NA
"3838","SC","501","Greenville, Anderson, Spartanburg/Upstate CoC",1829,1569,260,642,613,29,207,198,9,2016,304,179,125,141,115,26,4,NA
"3839","SC","502","Columbia/Midlands CoC",1350,1015,335,263,252,11,82,79,3,2016,313,166,147,224,182,42,4,NA
"3840","SC","503","Myrtle Beach, Sumter City & County CoC",1322,490,832,357,132,225,107,42,65,2016,229,49,180,231,43,188,12,NA
"3841","SD","500","South Dakota Statewide CoC",1072,887,185,524,441,83,170,143,27,2016,44,37,7,120,109,11,9,NA
"3842","TN","500","Chattanooga/Southeast Tennessee CoC",527,450,77,166,164,2,70,69,1,2016,91,49,42,53,43,10,0,NA
"3843","TN","501","Memphis/Shelby County CoC",1669,1548,121,548,548,0,165,165,0,2016,106,30,76,240,228,12,11,NA
"3844","TN","502","Knoxville/Knox County CoC",748,667,81,74,74,0,27,27,0,2016,134,55,79,102,98,4,1,NA
"3845","TN","503","Central Tennessee CoC",296,270,26,69,69,0,27,27,0,2016,32,30,2,48,46,2,0,NA
"3846","TN","504","Nashville-Davidson County CoC",2365,1692,673,296,296,0,113,113,0,2016,978,406,572,230,169,61,6,NA
"3847","TN","506","Upper Cumberland CoC",249,187,62,114,86,28,40,32,8,2016,30,17,13,13,10,3,0,NA
"3848","TN","507","Jackson/West Tennessee CoC",1541,163,1378,422,46,376,142,17,125,2016,164,14,150,57,2,55,1,NA
"3849","TN","509","Appalachian Regional CoC",448,299,149,82,82,0,28,28,0,2016,117,56,61,56,40,16,3,NA
"3850","TN","510","Murfreesboro/Rutherford County CoC",306,187,119,68,52,16,13,9,4,2016,37,7,30,21,15,6,2,NA
"3851","TN","512","Morristown/Blount, Sevier, Campbell, Cocke Counties CoC",630,310,320,288,154,134,85,47,38,2016,93,30,63,11,3,8,2,NA
"3852","TX","500","San Antonio/Bexar County CoC",2781,1644,1137,733,695,38,235,226,9,2016,521,217,304,263,164,99,29,NA
"3853","TX","503","Austin/Travis County CoC",2138,1322,816,625,618,7,182,179,3,2016,742,173,569,257,150,107,10,NA
"3854","TX","600","Dallas City & County, Irving CoC",3810,3071,739,1177,1171,6,420,418,2,2016,597,464,133,307,253,54,34,NA
"3855","TX","601","Fort Worth, Arlington/Tarrant County CoC",1938,1515,423,559,534,25,183,175,8,2016,189,109,80,205,175,30,11,NA
"3856","TX","603","El Paso City & County CoC",1100,987,113,516,516,0,148,148,0,2016,105,69,36,71,58,13,3,NA
"3857","TX","604","Waco/McLennan County CoC",267,224,43,147,147,0,43,43,0,2016,35,14,21,17,11,6,2,NA
"3858","TX","607","Texas Balance of State CoC",6048,3660,2388,2150,1977,173,665,610,55,2016,853,338,515,64,40,24,69,NA
"3859","TX","611","Amarillo CoC",592,572,20,147,147,0,49,49,0,2016,85,79,6,57,54,3,0,NA
"3860","TX","624","Wichita Falls/Wise, Palo Pinto, Wichita, Archer Counties CoC",256,234,22,52,52,0,24,24,0,2016,36,36,0,0,0,0,12,NA
"3861","TX","700","Houston, Pasadena, Conroe/Harris, Ft. Bend, Montgomery, Counties CoC",4031,2835,1196,976,966,10,326,323,3,2016,516,132,384,523,376,147,17,NA
"3862","TX","701","Bryan, College Station/Brazos Valley CoC",161,150,11,81,76,5,22,21,1,2016,10,6,4,4,4,0,0,NA
"3863","UT","500","Salt Lake City & County CoC",1891,1834,57,631,631,0,188,188,0,2016,164,161,3,275,268,7,0,NA
"3864","UT","503","Utah Balance of State CoC",738,600,138,277,257,20,87,80,7,2016,17,14,3,57,41,16,10,NA
"3865","UT","504","Provo/Mountainland CoC",178,137,41,71,71,0,23,23,0,2016,9,5,4,3,2,1,8,NA
"3866","VA","500","Richmond/Henrico, Chesterfield, Hanover Counties CoC",762,692,70,138,138,0,44,44,0,2016,94,81,13,118,105,13,0,NA
"3867","VA","501","Norfolk/Chesapeake, Suffolk, Isle of Wight, Southampton Counties CoC",723,638,85,197,175,22,58,51,7,2016,34,28,6,78,71,7,0,NA
"3868","VA","502","Roanoke City & County, Salem CoC",308,301,7,90,90,0,42,42,0,2016,73,71,2,45,44,1,0,NA
"3869","VA","503","Virginia Beach CoC",389,339,50,155,155,0,46,46,0,2016,27,19,8,40,34,6,10,NA
"3870","VA","504","Charlottesville CoC",157,135,22,46,46,0,19,19,0,2016,33,17,16,16,12,4,1,NA
"3871","VA","505","Newport News, Hampton/Virginia Peninsula CoC",464,407,57,145,145,0,48,48,0,2016,53,35,18,65,58,7,0,NA
"3872","VA","507","Portsmouth CoC",169,124,45,50,50,0,20,20,0,2016,12,12,0,10,5,5,0,NA
"3873","VA","508","Lynchburg CoC",174,153,21,49,49,0,15,15,0,2016,17,10,7,12,12,0,0,NA
"3874","VA","513","Harrisburg, Winchester/Western Virginia CoC",268,261,7,95,95,0,28,28,0,2016,69,63,6,10,10,0,0,NA
"3875","VA","514","Fredericksburg/Spotsylvania, Stafford Counties CoC",209,175,34,82,82,0,22,22,0,2016,13,5,8,13,9,4,0,NA
"3876","VA","521","Virginia Balance of State CoC",654,498,156,260,235,25,85,77,8,2016,58,34,24,29,24,5,0,NA
"3877","VA","600","Arlington County CoC",174,155,19,50,50,0,18,18,0,2016,41,28,13,5,5,0,0,NA
"3878","VA","601","Fairfax County CoC",1059,985,74,575,575,0,178,178,0,2016,149,106,43,37,25,12,1,NA
"3879","VA","602","Loudoun County CoC",134,115,19,69,69,0,20,20,0,2016,16,9,7,4,3,1,0,NA
"3880","VA","603","Alexandria CoC",224,212,12,95,95,0,28,28,0,2016,47,36,11,5,5,0,0,NA
"3881","VA","604","Prince William County CoC",400,312,88,213,208,5,66,64,2,2016,57,14,43,28,17,11,0,NA
"3882","VT","500","Vermont Balance of State CoC",785,691,94,335,318,17,115,109,6,2016,59,44,15,79,73,6,1,NA
"3883","VT","501","Burlington/Chittenden County CoC",332,270,62,127,127,0,43,43,0,2016,68,37,31,31,24,7,0,NA
"3884","WA","500","Seattle/King County CoC",10730,6225,4505,2982,2926,56,932,904,28,2016,814,456,358,656,536,120,26,NA
"3885","WA","501","Washington Balance of State CoC",5706,3107,2599,2314,1641,673,719,521,198,2016,860,176,684,437,223,214,21,NA
"3886","WA","502","Spokane City & County CoC",981,809,172,304,296,8,103,100,3,2016,188,94,94,103,90,13,8,NA
"3887","WA","503","Tacoma, Lakewood/Pierce County CoC",1762,1268,494,700,631,69,231,204,27,2016,388,182,206,190,100,90,9,NA
"3888","WA","504","Everett/Snohomish County CoC",960,489,471,258,223,35,88,78,10,2016,254,43,211,58,22,36,23,NA
"3889","WA","508","Vancouver/Clark County CoC",688,463,225,369,255,114,112,71,41,2016,63,30,33,40,28,12,5,NA
"3890","WI","500","Wisconsin Balance of State CoC",3445,3313,132,1898,1885,13,582,578,4,2016,187,164,23,236,228,8,2,NA
"3891","WI","501","Milwaukee City & County CoC",1415,1208,207,559,556,3,170,169,1,2016,58,43,15,97,87,10,16,NA
"3892","WI","502","Racine City & County CoC",196,195,1,73,73,0,22,22,0,2016,2,2,0,33,33,0,4,NA
"3893","WI","503","Madison/Dane County CoC",629,559,70,269,266,3,88,87,1,2016,116,87,29,49,44,5,3,NA
"3894","WV","500","Wheeling, Weirton Area CoC",91,88,3,27,27,0,10,10,0,2016,28,27,1,9,8,1,0,NA
"3895","WV","501","Huntington/Cabell, Wayne Counties CoC",228,212,16,92,92,0,29,29,0,2016,13,5,8,11,8,3,0,NA
"3896","WV","503","Charleston/Kanawha, Putnam, Boone, Clay Counties CoC",320,288,32,54,54,0,19,19,0,2016,40,29,11,24,19,5,5,NA
"3897","WV","508","West Virginia Balance of State CoC",748,664,84,175,175,0,55,55,0,2016,84,56,28,99,91,8,1,NA
"3898","WY","500","Wyoming Statewide CoC",857,491,366,340,214,126,110,77,33,2016,91,33,58,87,56,31,3,NA
"3899",NA,NA,"Total",549928,373571,176357,194716,175563,19153,61265,55265,6000,2016,86132,30108,56024,39471,26404,13067,3824,NA
"3900","AK","500","Anchorage CoC",1128,973,155,280,280,0,87,87,0,2017,116,72,44,69,57,12,8,NA
"3901","AK","501","Alaska Balance of State CoC",717,578,139,211,211,0,78,78,0,2017,141,86,55,55,38,17,7,NA
"3902","AL","500","Birmingham/Jefferson, St. Clair, Shelby Counties CoC",1092,875,217,160,160,0,60,60,0,2017,92,31,61,40,29,11,2,NA
"3903","AL","501","Mobile City & County/Baldwin County CoC",606,341,265,180,162,18,57,52,5,2017,65,9,56,76,50,26,0,NA
"3904","AL","502","Florence/Northwest Alabama CoC",155,133,22,0,0,0,0,0,0,2017,24,10,14,11,3,8,0,NA
"3905","AL","503","Huntsville/North Alabama CoC",436,337,99,109,107,2,33,32,1,2017,64,49,15,27,23,4,13,NA
"3906","AL","504","Montgomery City & County CoC",377,314,63,93,89,4,30,29,1,2017,45,39,6,55,53,2,5,NA
"3907","AL","505","Gadsden/Northeast Alabama CoC",163,103,60,33,33,0,8,8,0,2017,43,15,28,4,1,3,14,NA
"3908","AL","506","Tuscaloosa City & County CoC",200,137,63,60,60,0,17,17,0,2017,24,15,9,41,34,7,0,NA
"3909","AL","507","Alabama Balance of State CoC",764,416,348,173,95,78,57,31,26,2017,6,3,3,15,9,6,2,NA
"3910","AR","500","Little Rock/Central Arkansas CoC",1006,456,550,114,82,32,40,28,12,2017,226,76,150,121,67,54,8,NA
"3911","AR","501","Fayetteville/Northwest Arkansas CoC",330,235,95,95,95,0,33,33,0,2017,66,29,37,46,29,17,0,NA
"3912","AR","503","Arkansas  Balance of State  CoC",875,414,461,114,94,20,28,22,6,2017,110,27,83,33,20,13,0,NA
"3913","AR","505","Southeast Arkansas CoC",88,88,0,39,39,0,10,10,0,2017,0,0,0,2,2,0,9,NA
"3914","AR","508","Fort Smith CoC",168,80,88,37,26,11,10,7,3,2017,71,15,56,37,12,25,0,NA
"3915","AR","512","Boone, Baxter, Marion, Newton Counties CoC",NA,NA,NA,NA,NA,NA,NA,NA,NA,2017,NA,NA,NA,NA,NA,NA,NA,NA
"3916","AZ","500","Arizona Balance of State CoC",1768,1046,722,334,264,70,98,81,17,2017,388,68,320,238,113,125,12,NA
"3917","AZ","501","Tucson/Pima County CoC",1574,1189,385,325,325,0,96,96,0,2017,225,169,56,243,187,56,4,NA
"3918","AZ","502","Phoenix, Mesa/Maricopa County CoC",5605,3546,2059,1800,1769,31,495,487,8,2017,939,309,630,489,341,148,39,NA
"3919","CA","500","San Jose/Santa Clara City & County CoC",7394,1946,5448,1075,779,296,294,223,71,2017,2097,302,1795,660,208,452,509,NA
"3920","CA","501","San Francisco CoC",6858,2505,4353,601,581,20,190,184,6,2017,2138,560,1578,684,328,356,104,NA
"3921","CA","502","Oakland, Berkeley/Alameda County CoC",5629,1766,3863,711,685,26,270,261,9,2017,1707,298,1409,531,153,378,72,NA
"3922","CA","503","Sacramento City & County CoC",3665,1613,2052,589,572,17,186,180,6,2017,1126,323,803,469,142,327,3,NA
"3923","CA","504","Santa Rosa, Petaluma/Sonoma County CoC",2835,988,1847,326,319,7,111,109,2,2017,598,134,464,211,66,145,116,NA
"3924","CA","505","Richmond/Contra Costa County CoC",1607,696,911,255,184,71,84,62,22,2017,331,130,201,99,50,49,0,NA
"3925","CA","506","Salinas/Monterey, San Benito Counties CoC",3364,850,2514,645,429,216,184,129,55,2017,902,43,859,123,67,56,152,NA
"3926","CA","507","Marin County CoC",1117,409,708,200,170,30,75,67,8,2017,359,67,292,94,27,67,18,NA
"3927","CA","508","Watsonville/Santa Cruz City & County CoC",2249,450,1799,403,234,169,129,75,54,2017,600,77,523,236,19,217,163,NA
"3928","CA","509","Mendocino County CoC",1238,160,1078,59,48,11,22,18,4,2017,97,38,59,24,11,13,0,NA
"3929","CA","510","Turlock, Modesto/Stanislaus County CoC",1661,840,821,405,332,73,118,98,20,2017,178,60,118,100,42,58,2,NA
"3930","CA","511","Stockton/San Joaquin County CoC",1542,975,567,526,508,18,165,160,5,2017,254,130,124,109,77,32,5,NA
"3931","CA","512","Daly/San Mateo County CoC",1253,616,637,431,356,75,116,97,19,2017,234,31,203,105,48,57,5,NA
"3932","CA","513","Visalia/Kings, Tulare Counties CoC",853,354,499,121,105,16,37,32,5,2017,251,20,231,45,15,30,0,NA
"3933","CA","514","Fresno City & County/Madera County CoC",2016,487,1529,274,274,0,82,82,0,2017,692,49,643,211,88,123,5,NA
"3934","CA","515","Roseville, Rocklin/Placer, Nevada Counties CoC",979,521,458,207,184,23,64,56,8,2017,232,67,165,44,20,24,0,NA
"3935","CA","516","Redding/Shasta, Siskiyou, Lassen, Plumas, Del Norte, Modoc, Sierra Counties CoC",934,530,404,213,175,38,68,55,13,2017,341,99,242,103,43,60,0,NA
"3936","CA","517","Napa City & County CoC",315,199,116,82,82,0,24,24,0,2017,134,81,53,17,8,9,0,NA
"3937","CA","518","Vallejo/Solano County CoC",1232,315,917,162,131,31,58,49,9,2017,434,60,374,156,51,105,18,NA
"3938","CA","519","Chico, Paradise/Butte County CoC",1195,450,745,198,141,57,66,48,18,2017,531,111,420,110,30,80,8,NA
"3939","CA","520","Merced City & County CoC",454,156,298,7,4,3,2,1,1,2017,120,1,119,17,0,17,0,NA
"3940","CA","521","Davis, Woodland/Yolo County CoC",459,250,209,141,136,5,39,38,1,2017,174,27,147,28,10,18,0,NA
"3941","CA","522","Humboldt County CoC",759,325,434,92,59,33,30,19,11,2017,310,42,268,91,51,40,23,NA
"3942","CA","523","Colusa, Glenn, Trinity Counties CoC",176,43,133,58,27,31,15,7,8,2017,34,0,34,12,0,12,0,NA
"3943","CA","524","Yuba City & County/Sutter County CoC",760,287,473,203,115,88,64,35,29,2017,150,74,76,47,20,27,1,NA
"3944","CA","525","El Dorado County CoC",602,106,496,156,18,138,60,7,53,2017,241,30,211,97,15,82,3,NA
"3945","CA","526","Amador, Calaveras, Mariposa, Tuolumne Counties CoC",367,103,264,108,64,44,37,21,16,2017,71,4,67,20,10,10,0,NA
"3946","CA","527","Tehama County CoC",124,68,56,21,21,0,9,9,0,2017,61,24,37,9,8,1,0,NA
"3947","CA","529","Lake County CoC",401,28,373,107,18,89,26,7,19,2017,178,2,176,23,0,23,0,NA
"3948","CA","530","Alpine, Inyo, Mono Counties CoC",121,5,116,19,2,17,4,1,3,2017,31,0,31,13,0,13,0,NA
"3949","CA","600","Los Angeles City & County CoC",52442,13972,38470,7856,6598,1258,2812,2280,532,2017,16249,998,15251,4440,1070,3370,94,NA
"3950","CA","601","San Diego City and County CoC",9160,3539,5621,1589,1296,293,514,423,91,2017,2176,389,1787,1067,613,454,68,NA
"3951","CA","602","Santa Ana, Anaheim/Orange County CoC",4792,2208,2584,1265,1199,66,398,378,20,2017,893,284,609,405,48,357,4,NA
"3952","CA","603","Santa Maria/Santa Barbara County CoC",1860,967,893,438,284,154,138,90,48,2017,226,126,100,100,51,49,36,NA
"3953","CA","604","Bakersfield/Kern County CoC",810,541,269,187,175,12,63,60,3,2017,289,123,166,90,62,28,0,NA
"3954","CA","606","Long Beach CoC",1863,655,1208,217,160,57,70,51,19,2017,694,148,546,318,208,110,0,NA
"3955","CA","607","Pasadena CoC",575,228,347,110,100,10,37,33,4,2017,202,47,155,30,11,19,5,NA
"3956","CA","608","Riverside City & County CoC",2406,768,1638,234,230,4,69,68,1,2017,418,77,341,148,57,91,30,NA
"3957","CA","609","San Bernardino City & County CoC",1866,687,1179,434,390,44,154,139,15,2017,441,14,427,161,50,111,22,NA
"3958","CA","611","Oxnard, San Buenaventura/Ventura County CoC",1152,488,664,183,142,41,79,67,12,2017,385,101,284,80,30,50,2,NA
"3959","CA","612","Glendale CoC",168,111,57,96,84,12,32,28,4,2017,67,25,42,4,0,4,0,NA
"3960","CA","613","Imperial County CoC",1154,128,1026,120,68,52,39,21,18,2017,105,3,102,21,0,21,4,NA
"3961","CA","614","San Luis Obispo County CoC",1125,303,822,148,135,13,49,44,5,2017,282,16,266,84,8,76,23,NA
"3962","CO","500","Colorado Balance of State CoC",4019,1511,2508,1451,543,908,429,162,267,2017,807,228,579,332,141,191,16,NA
"3963","CO","503","Metropolitan Denver CoC",5506,4612,894,1475,1411,64,439,423,16,2017,1083,629,454,548,476,72,26,NA
"3964","CO","504","Colorado Springs/El Paso County CoC",1415,958,457,443,408,35,125,117,8,2017,374,120,254,198,126,72,3,NA
"3965","CT","503","Bridgeport, Stamford, Norwalk/Fairfield County CoC",778,696,82,348,348,0,112,112,0,2017,52,36,16,48,46,2,10,NA
"3966","CT","505","Connecticut Balance of State CoC",2610,2276,334,832,828,4,280,279,1,2017,368,237,131,143,131,12,3,NA
"3967","DE","500","Delaware Statewide CoC",994,936,58,379,373,6,129,127,2,2017,127,102,25,91,85,6,2,NA
"3968","FL","500","Sarasota, Bradenton/Manatee, Sarasota Counties CoC",1447,785,662,245,188,57,74,60,14,2017,285,36,249,149,77,72,14,NA
"3969","FL","501","Tampa/Hillsborough County CoC",1549,982,567,479,464,15,154,151,3,2017,235,61,174,172,123,49,0,NA
"3970","FL","502","St. Petersburg, Clearwater, Largo/Pinellas County CoC",2831,1679,1152,365,365,0,115,115,0,2017,690,179,511,329,263,66,31,NA
"3971","FL","503","Lakeland, Winterhaven/Polk County CoC",512,363,149,170,168,2,45,44,1,2017,77,11,66,35,18,17,3,NA
"3972","FL","504","Daytona Beach, Daytona/Volusia, Flagler Counties CoC",753,305,448,198,183,15,63,58,5,2017,88,6,82,52,23,29,17,NA
"3973","FL","505","Fort Walton Beach/Okaloosa, Walton Counties CoC",401,130,271,154,116,38,44,36,8,2017,112,6,106,27,6,21,5,NA
"3974","FL","506","Tallahassee/Leon County CoC",1072,950,122,262,262,0,73,73,0,2017,117,58,59,110,100,10,14,NA
"3975","FL","507","Orlando/Orange, Osceola, Seminole Counties CoC",2074,1734,340,732,708,24,244,234,10,2017,194,87,107,218,207,11,0,NA
"3976","FL","508","Gainesville/Alachua, Putnam Counties CoC",819,373,446,120,115,5,31,29,2,2017,291,29,262,126,68,58,36,NA
"3977","FL","509","Fort Pierce/St. Lucie, Indian River, Martin Counties CoC",1732,183,1549,982,118,864,338,41,297,2017,57,0,57,72,0,72,60,NA
"3978","FL","510","Jacksonville-Duval, Clay Counties CoC",1869,1437,432,425,425,0,135,135,0,2017,319,167,152,125,100,25,34,NA
"3979","FL","511","Pensacola/Escambia, Santa Rosa Counties CoC",758,501,257,139,132,7,44,41,3,2017,135,28,107,117,76,41,0,NA
"3980","FL","512","St. Johns County CoC",445,179,266,150,132,18,42,38,4,2017,42,1,41,40,7,33,0,NA
"3981","FL","513","Palm Bay, Melbourne/Brevard County CoC",845,592,253,262,247,15,87,82,5,2017,167,53,114,210,171,39,18,NA
"3982","FL","514","Ocala/Marion County CoC",725,290,435,126,107,19,38,31,7,2017,147,10,137,72,60,12,30,NA
"3983","FL","515","Panama City/Bay, Jackson Counties CoC",336,143,193,51,14,37,14,5,9,2017,38,0,38,34,15,19,26,NA
"3984","FL","517","Hendry, Hardee, Highlands Counties CoC",609,91,518,232,82,150,79,32,47,2017,283,0,283,16,0,16,21,NA
"3985","FL","518","Columbia, Hamilton, Lafayette, Suwannee Counties CoC",502,99,403,130,53,77,44,16,28,2017,38,0,38,43,26,17,9,NA
"3986","FL","519","Pasco County CoC",2593,178,2415,1755,65,1690,444,22,422,2017,847,51,796,220,45,175,49,NA
"3987","FL","520","Citrus, Hernando, Lake, Sumter Counties CoC",635,282,353,191,144,47,61,48,13,2017,40,25,15,57,29,28,3,NA
"3988","FL","600","Miami-Dade County CoC",3721,2710,1011,1175,1175,0,341,341,0,2017,309,174,135,167,158,9,6,NA
"3989","FL","601","Ft Lauderdale/Broward County CoC",2450,1493,957,413,386,27,137,130,7,2017,581,169,412,197,92,105,14,NA
"3990","FL","602","Punta Gorda/Charlotte County CoC",222,89,133,57,25,32,13,7,6,2017,33,4,29,55,53,2,0,NA
"3991","FL","603","Ft Myers, Cape Coral/Lee County CoC",431,244,187,114,102,12,35,32,3,2017,65,21,44,13,4,9,12,NA
"3992","FL","604","Monroe County CoC",631,339,292,50,47,3,18,17,1,2017,83,1,82,87,57,30,11,NA
"3993","FL","605","West Palm Beach/Palm Beach County CoC",1607,526,1081,326,300,26,101,93,8,2017,252,18,234,65,39,26,8,NA
"3994","FL","606","Naples/Collier County CoC",621,434,187,119,57,62,32,13,19,2017,90,46,44,9,4,5,0,NA
"3995","GA","500","Atlanta CoC",3572,2891,681,483,469,14,163,158,5,2017,346,215,131,386,321,65,11,NA
"3996","GA","501","Georgia Balance of State CoC",3716,1843,1873,1497,1328,169,620,551,69,2017,242,74,168,157,40,117,3,NA
"3997","GA","502","Fulton County CoC",293,203,90,76,70,6,27,25,2,2017,2,0,2,19,18,1,2,NA
"3998","GA","503","Athens-Clarke County CoC",239,146,93,57,57,0,19,19,0,2017,53,18,35,9,5,4,0,NA
"3999","GA","504","Augusta-Richmond County CoC",246,199,47,29,29,0,11,11,0,2017,30,28,2,44,39,5,0,NA
"4000","GA","505","Columbus-Muscogee/Russell County CoC",319,246,73,74,74,0,21,21,0,2017,21,21,0,17,12,5,2,NA
"4001","GA","506","Marietta/Cobb County CoC",403,285,118,167,153,14,46,42,4,2017,53,20,33,21,7,14,0,NA
"4002","GA","507","Savannah/Chatham County CoC",926,563,363,175,175,0,53,53,0,2017,234,67,167,38,11,27,10,NA
"4003","GA","508","DeKalb County CoC",460,275,185,194,194,0,59,59,0,2017,47,19,28,21,13,8,0,NA
"4004","HI","500","Hawaii Balance of State CoC",2261,785,1476,838,540,298,208,140,68,2017,641,52,589,166,23,143,2,NA
"4005","HI","501","Honolulu City and County CoC",4959,2635,2324,1847,1622,225,458,399,59,2017,1159,155,1004,449,214,235,24,NA
"4006","IA","500","Sioux City/Dakota, Woodbury Counties CoC",288,286,2,129,129,0,39,39,0,2017,17,15,2,12,11,1,0,NA
"4007","IA","501","Iowa Balance of State CoC",1792,1742,50,985,985,0,294,294,0,2017,107,90,17,81,70,11,8,NA
"4008","IA","502","Des Moines/Polk County CoC",676,624,52,142,142,0,49,49,0,2017,75,38,37,78,72,6,4,NA
"4009","ID","500","Boise/Ada County CoC",833,722,111,162,148,14,46,42,4,2017,327,270,57,124,112,12,2,NA
"4010","ID","501","Idaho Balance of State CoC",1204,676,528,566,393,173,165,125,40,2017,109,32,77,104,47,57,5,NA
"4011","IL","500","McHenry County CoC",155,150,5,68,68,0,21,21,0,2017,5,1,4,24,24,0,5,NA
"4012","IL","501","Rockford/Winnebago, Boone Counties CoC",291,259,32,113,113,0,38,38,0,2017,31,14,17,23,20,3,0,NA
"4013","IL","502","Waukegan, North Chicago/Lake County CoC",228,201,27,106,106,0,32,32,0,2017,18,8,10,8,5,3,0,NA
"4014","IL","503","Champaign, Urbana, Rantoul/Champaign County CoC",160,143,17,60,56,4,20,19,1,2017,11,8,3,6,3,3,5,NA
"4015","IL","504","Madison County CoC",176,155,21,125,122,3,35,34,1,2017,28,23,5,10,6,4,0,NA
"4016","IL","506","Joliet, Bolingbrook/Will County CoC",282,251,31,97,97,0,27,27,0,2017,24,11,13,18,17,1,0,NA
"4017","IL","507","Peoria, Pekin/Fulton, Tazewell, Peoria, Woodford Counties CoC",329,293,36,89,89,0,29,29,0,2017,73,60,13,32,32,0,0,NA
"4018","IL","508","East St. Louis, Belleville/St. Clair County CoC",300,154,146,126,98,28,42,33,9,2017,21,0,21,36,24,12,0,NA
"4019","IL","509","Dekalb City & County CoC",90,87,3,39,39,0,11,11,0,2017,0,0,0,2,2,0,0,NA
"4020","IL","510","Chicago CoC",5657,4096,1561,1933,1931,2,571,570,1,2017,863,291,572,528,283,245,3,NA
"4021","IL","511","Cook County CoC",780,688,92,272,269,3,93,92,1,2017,107,84,23,53,50,3,0,NA
"4022","IL","512","Bloomington/Central Illinois CoC",433,392,41,180,159,21,63,54,9,2017,52,45,7,21,18,3,28,NA
"4023","IL","513","Springfield/Sangamon County CoC",230,219,11,59,59,0,20,20,0,2017,29,26,3,16,14,2,0,NA
"4024","IL","514","DuPage County CoC",331,316,15,126,126,0,45,45,0,2017,36,33,3,8,8,0,3,NA
"4025","IL","515","South Central Illinois CoC",108,76,32,64,56,8,19,17,2,2017,5,3,2,3,3,0,0,NA
"4026","IL","516","Decatur/Macon County CoC",130,114,16,23,23,0,10,10,0,2017,23,21,2,11,9,2,1,NA
"4027","IL","517","Aurora, Elgin/Kane County CoC",360,335,25,94,94,0,27,27,0,2017,63,48,15,21,21,0,0,NA
"4028","IL","518","Rock Island, Moline/Northwestern Illinois CoC",243,234,9,111,111,0,37,37,0,2017,0,0,0,24,22,2,1,NA
"4029","IL","519","West Central Illinois CoC",80,80,0,31,31,0,12,12,0,2017,1,1,0,1,1,0,3,NA
"4030","IL","520","Southern Illinois CoC",435,298,137,188,135,53,76,53,23,2017,85,40,45,19,13,6,0,NA
"4031","IN","502","Indiana Balance of State CoC",3655,3212,443,1315,1287,28,418,409,9,2017,330,318,12,287,256,31,28,NA
"4032","IN","503","Indianapolis CoC",1783,1657,126,500,500,0,158,158,0,2017,207,165,42,328,313,15,2,NA
"4033","KS","502","Wichita/Sedgwick County CoC",575,464,111,180,180,0,54,54,0,2017,39,7,32,57,37,20,1,NA
"4034","KS","503","Topeka/Shawnee County CoC",356,322,34,109,109,0,36,36,0,2017,119,114,5,61,54,7,0,NA
"4035","KS","505","Overland Park, Shawnee/Johnson County CoC",130,113,17,96,96,0,33,33,0,2017,3,0,3,1,1,0,0,NA
"4036","KS","507","Kansas Balance of State CoC",1037,895,142,429,429,0,124,124,0,2017,135,107,28,74,64,10,4,NA
"4037","KY","500","Kentucky Balance of State CoC",1940,1415,525,614,535,79,201,177,24,2017,164,86,78,161,136,25,6,NA
"4038","KY","501","Louisville-Jefferson County CoC",1034,883,151,265,263,2,88,87,1,2017,123,87,36,166,151,15,11,NA
"4039","KY","502","Lexington-Fayette County CoC",1051,1000,51,114,114,0,45,45,0,2017,118,94,24,162,158,4,1,NA
"4040","LA","500","Lafayette/Acadiana CoC",357,261,96,131,114,17,37,33,4,2017,49,26,23,36,30,6,0,NA
"4041","LA","502","Shreveport, Bossier/Northwest Louisiana CoC",349,302,47,103,103,0,33,33,0,2017,31,8,23,83,82,1,3,NA
"4042","LA","503","New Orleans/Jefferson Parish CoC",1301,776,525,143,135,8,41,38,3,2017,404,124,280,113,96,17,5,NA
"4043","LA","505","Monroe/Northeast Louisiana CoC",185,160,25,109,109,0,36,36,0,2017,13,5,8,5,4,1,0,NA
"4044","LA","506","Slidell/Southeast Louisiana CoC",248,159,89,57,23,34,17,6,11,2017,26,4,22,48,40,8,0,NA
"4045","LA","507","Alexandria/Central Louisiana CoC",159,98,61,32,32,0,11,11,0,2017,20,3,17,16,11,5,0,NA
"4046","LA","509","Louisiana Balance of State CoC",706,574,132,171,167,4,56,54,2,2017,75,13,62,82,66,16,38,NA
"4047","MA","500","Boston CoC",6135,5949,186,3643,3643,0,1079,1079,0,2017,769,731,38,233,225,8,51,NA
"4048","MA","502","Lynn CoC",582,531,51,431,425,6,124,123,1,2017,57,6,51,0,0,0,0,NA
"4049","MA","503","Cape Cod Islands CoC",324,285,39,179,179,0,69,69,0,2017,47,16,31,20,14,6,1,NA
"4050","MA","504","Springfield/Hampden County CoC",2311,2258,53,1941,1941,0,513,513,0,2017,132,115,17,14,12,2,0,NA
"4051","MA","505","New Bedford CoC",352,303,49,178,178,0,52,52,0,2017,30,10,20,46,43,3,0,NA
"4052","MA","506","Worcester City & County CoC",1507,1371,136,923,917,6,282,279,3,2017,89,54,35,161,154,7,3,NA
"4053","MA","507","Pittsfield/Berkshire, Franklin, Hampshire Counties CoC",557,502,55,137,137,0,41,41,0,2017,79,50,29,213,209,4,0,NA
"4054","MA","508","Lowell CoC",658,646,12,476,476,0,143,143,0,2017,6,6,0,32,32,0,0,NA
"4055","MA","509","Cambridge CoC",530,463,67,135,135,0,52,52,0,2017,181,155,26,13,9,4,0,NA
"4056","MA","510","Gloucester, Haverhill, Salem/Essex County CoC",747,700,47,519,519,0,169,169,0,2017,195,170,25,30,26,4,0,NA
"4057","MA","511","Quincy, Brockton, Weymouth, Plymouth City and County CoC",1109,1059,50,750,750,0,254,254,0,2017,143,109,34,45,40,5,0,NA
"4058","MA","515","Fall River CoC",297,278,19,235,235,0,73,73,0,2017,7,6,1,1,0,1,0,NA
"4059","MA","516","Massachusetts Balance of State CoC",2080,1911,169,1564,1564,0,526,526,0,2017,144,107,37,19,18,1,2,NA
"4060","MA","517","Somerville CoC",142,120,22,34,34,0,13,13,0,2017,13,13,0,23,23,0,0,NA
"4061","MA","519","Attleboro, Taunton/Bristol County CoC",234,198,36,153,153,0,40,40,0,2017,22,7,15,3,3,0,0,NA
"4062","MD","500","Cumberland/Allegany County CoC",118,88,30,42,42,0,16,16,0,2017,19,14,5,1,0,1,0,NA
"4063","MD","501","Baltimore CoC",2669,2123,546,491,491,0,158,158,0,2017,699,409,290,276,252,24,8,NA
"4064","MD","502","Harford County CoC",189,152,37,87,87,0,28,28,0,2017,20,10,10,8,7,1,0,NA
"4065","MD","503","Annapolis/Anne Arundel County CoC",376,263,113,115,115,0,36,36,0,2017,91,38,53,21,15,6,0,NA
"4066","MD","504","Howard County CoC",168,115,53,75,66,9,25,22,3,2017,23,9,14,6,2,4,0,NA
"4067","MD","505","Baltimore County CoC",609,389,220,212,207,5,68,66,2,2017,144,26,118,32,20,12,0,NA
"4068","MD","506","Carroll County CoC",147,125,22,41,41,0,10,10,0,2017,20,17,3,8,6,2,0,NA
"4069","MD","507","Cecil County CoC",193,112,81,54,52,2,18,17,1,2017,37,8,29,39,36,3,0,NA
"4070","MD","508","Charles, Calvert, St.Mary's Counties CoC",419,187,232,181,57,124,49,17,32,2017,79,39,40,22,5,17,2,NA
"4071","MD","509","Frederick City & County CoC",309,206,103,92,92,0,32,32,0,2017,74,32,42,10,6,4,0,NA
"4072","MD","510","Garrett County CoC",10,10,0,6,6,0,3,3,0,2017,3,3,0,0,0,0,0,NA
"4073","MD","511","Mid-Shore Regional CoC",153,136,17,72,66,6,20,18,2,2017,24,15,9,6,5,1,0,NA
"4074","MD","512","Hagerstown/Washington County CoC",208,187,21,44,42,2,15,14,1,2017,48,38,10,40,35,5,0,NA
"4075","MD","513","Wicomico, Somerset, Worcester Counties CoC",260,218,42,48,48,0,14,14,0,2017,41,31,10,32,24,8,0,NA
"4076","MD","600","Prince George's County CoC",525,437,88,332,317,15,103,100,3,2017,35,15,20,21,16,5,1,NA
"4077","MD","601","Montgomery County CoC",894,763,131,278,273,5,86,84,2,2017,163,112,51,14,11,3,0,NA
"4078","ME","500","Maine Statewide CoC",2280,2100,180,928,856,72,307,286,21,2017,201,201,0,131,120,11,28,NA
"4079","MI","500","Michigan Balance of State CoC",1465,1226,239,681,634,47,217,200,17,2017,55,27,28,62,47,15,12,NA
"4080","MI","501","Detroit CoC",2078,1858,220,535,530,5,179,178,1,2017,249,144,105,337,320,17,8,NA
"4081","MI","502","Dearborn, Dearborn Heights, Westland/Wayne County CoC",226,212,14,148,148,0,44,44,0,2017,8,8,0,13,12,1,3,NA
"4082","MI","503","St. Clair Shores, Warren/Macomb County CoC",354,290,64,78,78,0,28,28,0,2017,31,28,3,56,56,0,3,NA
"4083","MI","504","Pontiac, Royal Oak/Oakland County CoC",412,365,47,131,131,0,42,42,0,2017,45,37,8,18,17,1,7,NA
"4084","MI","505","Flint/Genesee County CoC",420,295,125,165,149,16,47,43,4,2017,42,23,19,27,21,6,2,NA
"4085","MI","506","Grand Rapids, Wyoming/Kent County CoC",912,851,61,298,292,6,81,79,2,2017,108,92,16,92,83,9,7,NA
"4086","MI","507","Portage, Kalamazoo City & County CoC",479,451,28,235,235,0,75,75,0,2017,26,26,0,18,18,0,4,NA
"4087","MI","508","Lansing, East Lansing/Ingham County CoC",435,390,45,164,159,5,42,40,2,2017,45,31,14,27,25,2,7,NA
"4088","MI","509","Washtenaw County CoC",302,262,40,60,58,2,21,20,1,2017,43,29,14,38,35,3,2,NA
"4089","MI","510","Saginaw City & County CoC",388,373,15,200,193,7,58,56,2,2017,22,20,2,15,15,0,9,NA
"4090","MI","511","Lenawee County CoC",128,128,0,69,69,0,22,22,0,2017,15,15,0,2,2,0,0,NA
"4091","MI","512","Grand Traverse, Antrim, Leelanau Counties CoC",228,188,40,61,57,4,19,18,1,2017,37,21,16,18,15,3,3,NA
"4092","MI","513","Marquette, Alger Counties CoC",84,81,3,50,50,0,16,16,0,2017,4,4,0,1,1,0,0,NA
"4093","MI","514","Battle Creek/Calhoun County CoC",204,175,29,52,47,5,16,15,1,2017,22,13,9,23,22,1,7,NA
"4094","MI","515","Monroe City & County CoC",193,190,3,71,71,0,22,22,0,2017,13,13,0,17,16,1,4,NA
"4095","MI","516","Norton Shores, Muskegon City & County CoC",135,125,10,48,48,0,16,16,0,2017,2,1,1,5,5,0,0,NA
"4096","MI","517","Jackson City & County CoC",140,126,14,88,82,6,26,25,1,2017,2,2,0,1,1,0,1,NA
"4097","MI","518","Livingston County CoC",103,91,12,47,42,5,16,15,1,2017,1,1,0,1,0,1,1,NA
"4098","MI","519","Holland/Ottawa County CoC",258,250,8,146,146,0,45,45,0,2017,4,3,1,2,2,0,0,NA
"4099","MI","523","Eaton County CoC",107,101,6,96,94,2,28,27,1,2017,0,0,0,0,0,0,0,NA
"4100","MN","500","Minneapolis/Hennepin County CoC",3057,2759,298,1662,1658,4,453,451,2,2017,342,281,61,110,107,3,44,NA
"4101","MN","501","Saint Paul/Ramsey County CoC",1438,1272,166,533,527,6,183,181,2,2017,269,163,106,69,59,10,19,NA
"4102","MN","502","Rochester/Southeast Minnesota CoC",552,495,57,290,290,0,91,91,0,2017,38,19,19,10,6,4,7,NA
"4103","MN","503","Dakota, Anoka, Washington, Scott, Carver Counties",544,434,110,286,247,39,93,83,10,2017,74,38,36,22,22,0,5,NA
"4104","MN","504","Northeast Minnesota CoC",99,58,41,36,24,12,12,8,4,2017,8,1,7,3,3,0,1,NA
"4105","MN","505","St. Cloud/Central Minnesota CoC",862,633,229,410,385,25,127,120,7,2017,17,8,9,33,21,12,17,NA
"4106","MN","506","Northwest Minnesota CoC",288,285,3,185,185,0,59,59,0,2017,2,2,0,3,3,0,18,NA
"4107","MN","508","Moorhead/West Central Minnesota CoC",215,212,3,111,111,0,36,36,0,2017,18,18,0,8,8,0,1,NA
"4108","MN","509","Duluth/St.Louis County CoC",505,312,193,191,180,11,65,61,4,2017,138,22,116,21,13,8,19,NA
"4109","MN","511","Southwest Minnesota CoC",108,100,8,65,61,4,21,20,1,2017,0,0,0,2,2,0,5,NA
"4110","MO","500","St. Louis County CoC",462,418,44,208,208,0,72,72,0,2017,73,56,17,18,15,3,27,NA
"4111","MO","501","St.Louis City CoC",1336,1194,142,515,515,0,172,172,0,2017,151,81,70,169,158,11,4,NA
"4112","MO","503","St. Charles City & County, Lincoln, Warren Counties CoC",578,351,227,272,206,66,91,75,16,2017,36,22,14,11,4,7,23,NA
"4113","MO","600","Springfield/Greene, Christian, Webster Counties CoC",455,255,200,120,115,5,43,41,2,2017,190,78,112,34,8,26,5,NA
"4114","MO","602","Joplin/Jasper, Newton Counties CoC",270,229,41,75,73,2,26,25,1,2017,45,33,12,53,48,5,1,NA
"4115","MO","603","St. Joseph/Andrew, Buchanan, DeKalb Counties CoC",210,192,18,92,92,0,28,28,0,2017,62,48,14,9,8,1,3,NA
"4116","MO","604a","Kansas City, Independence, Lee’s Summit/Jackson, Wyandotte Counties, MO & KS",1671,1442,229,544,539,5,163,162,1,2017,330,231,99,170,145,25,11,NA
"4117","MO","606","Missouri Balance of State CoC",1244,952,292,493,412,81,170,145,25,2017,245,197,48,98,84,14,28,NA
"4118","MS","500","Jackson/Rankin, Madison Counties CoC",511,231,280,61,61,0,21,21,0,2017,20,13,7,0,0,0,20,NA
"4119","MS","501","Mississippi Balance of State CoC",697,451,246,232,191,41,66,53,13,2017,33,9,24,51,38,13,1,NA
"4120","MS","503","Gulf Port/Gulf Coast Regional CoC",264,71,193,79,49,30,24,16,8,2017,19,2,17,6,1,5,0,NA
"4121","MT","500","Montana Statewide CoC",1529,985,544,542,352,190,169,117,52,2017,198,75,123,205,125,80,14,NA
"4122","NC","500","Winston-Salem/Forsyth County CoC",453,428,25,102,102,0,34,34,0,2017,60,58,2,60,55,5,0,NA
"4123","NC","501","Asheville/Buncombe County CoC",562,457,105,57,49,8,17,15,2,2017,83,43,40,239,225,14,6,NA
"4124","NC","502","Durham City & County CoC",354,294,60,100,100,0,29,29,0,2017,50,29,21,72,69,3,0,NA
"4125","NC","503","North Carolina Balance of State CoC",3054,2102,952,1143,914,229,347,282,65,2017,382,127,255,176,105,71,14,NA
"4126","NC","504","Greensboro, High Point CoC",573,469,104,151,151,0,47,47,0,2017,30,12,18,60,53,7,24,NA
"4127","NC","505","Charlotte/Mecklenberg CoC",1476,1261,215,460,456,4,148,146,2,2017,147,78,69,137,113,24,5,NA
"4128","NC","506","Wilmington/Brunswick, New Hanover, Pender Counties CoC",322,235,87,66,63,3,21,20,1,2017,44,2,42,48,34,14,7,NA
"4129","NC","507","Raleigh/Wake County CoC",884,696,188,297,286,11,92,89,3,2017,91,33,58,68,47,21,4,NA
"4130","NC","509","Gastonia/Cleveland, Gaston, Lincoln Counties CoC",249,171,78,85,62,23,27,21,6,2017,25,1,24,14,9,5,7,NA
"4131","NC","511","Fayetteville/Cumberland County CoC",442,189,253,163,133,30,51,41,10,2017,136,6,130,41,10,31,0,NA
"4132","NC","513","Chapel Hill/Orange County CoC",127,90,37,27,27,0,9,9,0,2017,14,1,13,11,7,4,0,NA
"4133","NC","516","Northwest North Carolina CoC",466,119,347,267,39,228,89,15,74,2017,13,6,7,5,5,0,1,NA
"4134","ND","500","North Dakota Statewide CoC",1089,758,331,257,108,149,77,36,41,2017,45,25,20,74,58,16,17,NA
"4135","NE","500","Nebraska Balance of State CoC",506,492,14,230,230,0,72,72,0,2017,10,7,3,17,16,1,7,NA
"4136","NE","501","Omaha, Council Bluffs CoC",1389,1332,57,352,352,0,134,134,0,2017,290,252,38,104,103,1,0,NA
"4137","NE","502","Lincoln CoC",606,557,49,221,221,0,60,60,0,2017,75,40,35,53,53,0,4,NA
"4138","NH","500","New Hampshire Balance of State CoC",767,657,110,343,315,28,114,100,14,2017,106,50,56,37,29,8,0,NA
"4139","NH","501","Manchester CoC",394,342,52,202,194,8,78,75,3,2017,18,9,9,33,30,3,0,NA
"4140","NH","502","Nashua/Hillsborough County CoC",295,283,12,135,135,0,46,46,0,2017,13,3,10,54,54,0,0,NA
"4141","NJ","500","Atlantic City & County CoC",422,313,109,40,40,0,15,15,0,2017,104,57,47,56,51,5,0,NA
"4142","NJ","501","Bergen County CoC",302,297,5,120,120,0,35,35,0,2017,3,1,2,16,15,1,8,NA
"4143","NJ","502","Burlington County CoC",604,560,44,274,274,0,84,84,0,2017,109,92,17,17,7,10,4,NA
"4144","NJ","503","Camden City & County/Gloucester, Cape May, Cumberland Counties CoC",938,811,127,309,309,0,98,98,0,2017,85,51,34,146,136,10,0,NA
"4145","NJ","504","Newark/Essex County CoC",2048,1620,428,795,788,7,272,269,3,2017,181,86,95,52,34,18,12,NA
"4146","NJ","506","Jersey City, Bayonne/Hudson County CoC",822,638,184,154,154,0,58,58,0,2017,174,103,71,27,19,8,0,NA
"4147","NJ","507","New Brunswick/Middlesex County CoC",546,421,125,228,228,0,73,73,0,2017,69,37,32,19,11,8,0,NA
"4148","NJ","508","Monmouth County CoC",299,255,44,155,155,0,49,49,0,2017,44,29,15,16,9,7,0,NA
"4149","NJ","509","Morris County CoC",378,351,27,155,155,0,52,52,0,2017,71,57,14,11,9,2,0,NA
"4150","NJ","510","Lakewood Township/Ocean County CoC",224,181,43,105,105,0,34,34,0,2017,24,8,16,6,1,5,11,NA
"4151","NJ","511","Paterson/Passaic County CoC",449,360,89,200,196,4,63,62,1,2017,58,36,22,12,7,5,2,NA
"4152","NJ","512","Salem County CoC",16,13,3,8,8,0,2,2,0,2017,0,0,0,0,0,0,0,NA
"4153","NJ","513","Somerset County CoC",244,239,5,68,68,0,23,23,0,2017,3,1,2,100,100,0,7,NA
"4154","NJ","514","Trenton/Mercer County CoC",478,394,84,122,119,3,40,39,1,2017,69,48,21,20,12,8,5,NA
"4155","NJ","515","Elizabeth/Union County CoC",480,425,55,275,270,5,91,89,2,2017,43,25,18,3,3,0,4,NA
"4156","NJ","516","Warren, Sussex, Hunterdon Counties CoC",286,244,42,95,95,0,29,29,0,2017,32,21,11,82,80,2,0,NA
"4157","NM","500","Albuquerque CoC",1318,934,384,214,198,16,61,56,5,2017,379,209,170,163,122,41,39,NA
"4158","NM","501","New Mexico Balance of State CoC",1164,752,412,403,341,62,130,108,22,2017,435,254,181,85,13,72,39,NA
"4159","NV","500","Las Vegas/Clark County CoC",6490,2137,4353,300,292,8,111,108,3,2017,446,86,360,691,367,324,256,NA
"4160","NV","501","Reno, Sparks/Washoe County CoC",1106,1026,80,195,195,0,55,55,0,2017,38,29,9,125,121,4,5,NA
"4161","NV","502","Nevada Balance of State CoC",237,92,145,57,47,10,20,16,4,2017,28,8,20,16,4,12,1,NA
"4162","NY","500","Rochester, Irondequoit, Greece/Monroe County CoC",817,752,65,307,307,0,99,99,0,2017,184,137,47,63,56,7,14,NA
"4163","NY","501","Elmira/Steuben, Allegany, Livingston, Chemung, Schuyler Counties CoC",226,189,37,106,99,7,31,29,2,2017,6,1,5,9,7,2,0,NA
"4164","NY","503","Albany City & County CoC",802,777,25,287,287,0,102,102,0,2017,82,63,19,86,84,2,7,NA
"4165","NY","504","Cattaragus County CoC",34,34,0,10,10,0,4,4,0,2017,1,1,0,2,2,0,0,NA
"4166","NY","505","Syracuse, Auburn/Onondaga, Oswego, Cayuga Counties CoC",798,770,28,217,212,5,77,76,1,2017,43,42,1,49,48,1,9,NA
"4167","NY","507","Schenectady City & County CoC",274,251,23,103,103,0,35,35,0,2017,15,12,3,11,11,0,1,NA
"4168","NY","508","Buffalo, Niagara Falls/Erie, Niagara, Orleans, Genesee, Wyoming Counties CoC",925,907,18,330,330,0,110,110,0,2017,24,21,3,91,89,2,13,NA
"4169","NY","510","Ithaca/Tompkins County CoC",73,53,20,19,19,0,7,7,0,2017,5,0,5,1,1,0,0,NA
"4170","NY","511","Binghamton, Union Town/Broome, Otsego, Chenango, Delaware, Cortland, Tioga Count",308,246,62,37,35,2,10,9,1,2017,5,1,4,13,13,0,8,NA
"4171","NY","512","Troy/Rensselaer County CoC",194,175,19,92,92,0,30,30,0,2017,18,17,1,8,6,2,1,NA
"4172","NY","513","Wayne, Ontario, Seneca, Yates Counties CoC",337,326,11,83,83,0,33,33,0,2017,29,25,4,31,31,0,0,NA
"4173","NY","514","Jamestown, Dunkirk/Chautauqua County CoC",83,80,3,42,42,0,14,14,0,2017,0,0,0,1,1,0,5,NA
"4174","NY","516","Clinton County CoC",126,125,1,53,53,0,16,16,0,2017,8,7,1,4,4,0,0,NA
"4175","NY","518","Utica, Rome/Oneida, Madison Counties CoC",162,146,16,76,69,7,25,23,2,2017,8,6,2,0,0,0,0,NA
"4176","NY","519","Columbia, Greene Counties CoC",144,141,3,72,72,0,23,23,0,2017,15,14,1,4,4,0,3,NA
"4177","NY","520","Franklin, Essex Counties CoC",28,27,1,7,7,0,3,3,0,2017,1,0,1,5,4,1,0,NA
"4178","NY","522","Jefferson, Lewis, St. Lawrence Counties CoC",169,134,35,40,25,15,15,10,5,2017,12,1,11,12,9,3,0,NA
"4179","NY","523","Glens Falls, Saratoga Springs/Saratoga, Washington, Warren, Hamilton Counties Co",247,239,8,72,69,3,27,26,1,2017,12,11,1,28,28,0,4,NA
"4180","NY","600","New York City CoC",76501,72565,3936,45377,45377,0,14245,14245,0,2017,5755,3955,1800,535,507,28,5,NA
"4181","NY","601","Poughkeepsie/Dutchess County CoC",388,379,9,181,181,0,58,58,0,2017,6,6,0,8,7,1,5,NA
"4182","NY","602","Newburgh, Middletown/Orange County CoC",350,320,30,164,164,0,55,55,0,2017,17,11,6,2,1,1,6,NA
"4183","NY","603","Nassau, Suffolk Counties CoC",3937,3873,64,2943,2943,0,793,793,0,2017,141,121,20,141,138,3,4,NA
"4184","NY","604","Yonkers, Mount Vernon/Westchester County CoC",1832,1785,47,1163,1163,0,383,383,0,2017,149,131,18,121,116,5,6,NA
"4185","NY","606","Rockland County CoC",170,112,58,35,35,0,13,13,0,2017,28,9,19,2,2,0,0,NA
"4186","NY","607","Sullivan County CoC",167,165,2,53,53,0,21,21,0,2017,0,0,0,9,9,0,4,NA
"4187","NY","608","Kingston/Ulster County CoC",411,377,34,244,228,16,68,64,4,2017,14,6,8,8,8,0,6,NA
"4188","OH","500","Cincinnati/Hamilton County CoC",1162,1088,74,273,273,0,80,80,0,2017,90,64,26,192,190,2,12,NA
"4189","OH","501","Toledo/Lucas County CoC",499,483,16,242,242,0,65,65,0,2017,38,36,2,51,49,2,5,NA
"4190","OH","502","Cleveland/Cuyahoga County CoC",1727,1630,97,367,367,0,111,111,0,2017,120,84,36,172,162,10,0,NA
"4191","OH","503","Columbus/Franklin County CoC",1691,1351,340,449,449,0,129,129,0,2017,229,94,135,140,119,21,10,NA
"4192","OH","504","Youngstown/Mahoning County CoC",262,256,6,99,99,0,26,26,0,2017,16,12,4,15,15,0,11,NA
"4193","OH","505","Dayton, Kettering/Montgomery County CoC",619,566,53,160,160,0,45,45,0,2017,30,24,6,60,58,2,5,NA
"4194","OH","506","Akron, Barberton/Summit County CoC",507,429,78,115,112,3,38,37,1,2017,56,27,29,62,56,6,10,NA
"4195","OH","507","Ohio Balance of State CoC",3309,2686,623,1530,1418,112,479,446,33,2017,180,79,101,160,128,32,11,NA
"4196","OH","508","Canton, Massillon, Alliance/Stark County CoC",319,297,22,172,172,0,52,52,0,2017,13,5,8,10,8,2,0,NA
"4197","OK","500","North Central Oklahoma CoC",192,147,45,110,96,14,38,33,5,2017,6,0,6,1,0,1,3,NA
"4198","OK","501","Tulsa City & County CoC",1074,900,174,255,238,17,80,75,5,2017,137,63,74,106,80,26,4,NA
"4199","OK","502","Oklahoma City CoC",1368,1100,268,359,355,4,118,117,1,2017,254,119,135,147,112,35,0,NA
"4200","OK","503","Oklahoma Balance of State CoC",432,139,293,281,97,184,114,32,82,2017,36,15,21,1,1,0,11,NA
"4201","OK","504","Norman/Cleveland County CoC",174,98,76,19,19,0,7,7,0,2017,111,79,32,10,8,2,0,NA
"4202","OK","505","Northeast Oklahoma CoC",377,325,52,168,132,36,61,50,11,2017,41,29,12,19,17,2,12,NA
"4203","OK","506","Southwest Oklahoma Regional CoC",231,169,62,81,78,3,27,26,1,2017,0,0,0,25,5,20,0,NA
"4204","OK","507","Southeastern Oklahoma Regional CoC",351,206,145,102,77,25,35,29,6,2017,75,43,32,40,12,28,15,NA
"4205","OR","500","Eugene, Springfield/Lane County CoC",1529,526,1003,269,153,116,84,50,34,2017,640,143,497,164,44,120,9,NA
"4206","OR","501","Portland, Gresham/Multnomah County CoC",4177,2509,1668,657,580,77,216,188,28,2017,1290,373,917,445,262,183,14,NA
"4207","OR","502","Medford, Ashland/Jackson County CoC",633,369,264,108,79,29,37,29,8,2017,170,59,111,95,65,30,17,NA
"4208","OR","503","Central Oregon CoC",778,230,548,284,46,238,76,15,61,2017,246,30,216,83,26,57,7,NA
"4209","OR","505","Oregon Balance of State CoC",5795,2026,3769,1893,679,1214,575,208,367,2017,737,224,513,379,139,240,460,NA
"4210","OR","506","Hillsboro, Beaverton/Washington County CoC",544,175,369,196,89,107,56,30,26,2017,150,10,140,58,40,18,8,NA
"4211","OR","507","Clackamas County CoC",497,151,346,112,67,45,39,20,19,2017,154,29,125,27,7,20,0,NA
"4212","PA","500","Philadelphia CoC",5693,4737,956,2352,2348,4,825,824,1,2017,898,424,474,244,204,40,26,NA
"4213","PA","501","Harrisburg/Dauphin County CoC",460,390,70,151,151,0,52,52,0,2017,45,32,13,39,29,10,0,NA
"4214","PA","502","Upper Darby, Chester, Haverford/Delaware County CoC",453,413,40,202,202,0,64,64,0,2017,26,16,10,11,10,1,0,NA
"4215","PA","503","Wilkes-Barre, Hazleton/Luzerne County CoC",174,171,3,92,92,0,29,29,0,2017,0,0,0,15,14,1,0,NA
"4216","PA","504","Lower Merion, Norristown, Abington/Montgomery County CoC",310,291,19,179,179,0,56,56,0,2017,40,35,5,13,9,4,0,NA
"4217","PA","505","Chester County CoC",578,554,24,191,189,2,65,64,1,2017,12,12,0,224,223,1,0,NA
"4218","PA","506","Reading/Berks County CoC",534,521,13,168,168,0,52,52,0,2017,2,0,2,38,38,0,0,NA
"4219","PA","508","Scranton/Lackawanna County CoC",197,183,14,99,99,0,32,32,0,2017,13,7,6,26,26,0,0,NA
"4220","PA","509","Eastern Pennsylvania CoC",2170,1765,405,961,936,25,306,299,7,2017,156,104,52,82,66,16,18,NA
"4221","PA","510","Lancaster City & County CoC",321,295,26,141,141,0,50,50,0,2017,6,4,2,23,23,0,0,NA
"4222","PA","511","Bristol, Bensalem/Bucks County CoC",511,462,49,313,313,0,100,100,0,2017,27,20,7,12,9,3,1,NA
"4223","PA","512","York City & County CoC",288,243,45,154,147,7,45,43,2,2017,12,7,5,9,8,1,8,NA
"4224","PA","600","Pittsburgh, McKeesport, Penn Hills/Allegheny County CoC",1145,1092,53,389,389,0,120,120,0,2017,131,112,19,102,95,7,0,NA
"4225","PA","601","Western Pennsylvania CoC",837,774,63,306,294,12,98,94,4,2017,29,21,8,94,92,2,5,NA
"4226","PA","603","Beaver County CoC",98,88,10,64,58,6,18,17,1,2017,12,5,7,2,2,0,0,NA
"4227","PA","605","Erie City & County CoC",369,361,8,105,105,0,34,34,0,2017,29,29,0,29,27,2,2,NA
"4228","RI","500","Rhode Island Statewide CoC",1180,1111,69,378,378,0,106,106,0,2017,240,215,25,95,92,3,1,NA
"4229","SC","500","Charleston/Low Country CoC",425,221,204,32,22,10,9,6,3,2017,108,21,87,127,92,35,0,NA
"4230","SC","501","Greenville, Anderson, Spartanburg/Upstate CoC",1317,932,385,419,379,40,134,122,12,2017,230,74,156,73,47,26,0,NA
"4231","SC","502","Columbia/Midlands CoC",1200,893,307,261,243,18,89,84,5,2017,295,119,176,153,144,9,6,NA
"4232","SC","503","Myrtle Beach, Sumter City & County CoC",974,369,605,308,104,204,93,42,51,2017,191,22,169,127,38,89,2,NA
"4233","SD","500","South Dakota Statewide CoC",943,772,171,332,320,12,124,121,3,2017,144,112,32,130,123,7,19,NA
"4234","TN","500","Chattanooga/Southeast Tennessee CoC",576,359,217,124,120,4,46,45,1,2017,192,88,104,54,23,31,0,NA
"4235","TN","501","Memphis/Shelby County CoC",1426,1347,79,511,511,0,130,130,0,2017,66,24,42,213,204,9,8,NA
"4236","TN","502","Knoxville/Knox County CoC",812,678,134,111,101,10,40,36,4,2017,77,54,23,87,85,2,3,NA
"4237","TN","503","Central Tennessee CoC",285,260,25,84,84,0,26,26,0,2017,45,40,5,55,52,3,0,NA
"4238","TN","504","Nashville-Davidson County CoC",2337,1698,639,347,337,10,82,80,2,2017,617,219,398,223,184,39,6,NA
"4239","TN","506","Upper Cumberland CoC",252,168,84,95,69,26,30,23,7,2017,25,20,5,15,11,4,1,NA
"4240","TN","507","Jackson/West Tennessee CoC",1103,134,969,396,75,321,134,27,107,2017,212,28,184,36,3,33,4,NA
"4241","TN","509","Appalachian Regional CoC",450,305,145,108,83,25,35,27,8,2017,73,24,49,43,34,9,0,NA
"4242","TN","510","Murfreesboro/Rutherford County CoC",316,227,89,67,67,0,29,29,0,2017,73,50,23,21,17,4,0,NA
"4243","TN","512","Morristown/Blount, Sevier, Campbell, Cocke Counties CoC",752,368,384,329,214,115,103,71,32,2017,104,24,80,10,2,8,1,NA
"4244","TX","500","San Antonio/Bexar County CoC",2743,1641,1102,844,840,4,242,241,1,2017,651,100,551,228,154,74,0,NA
"4245","TX","503","Austin/Travis County CoC",2036,1202,834,576,573,3,171,170,1,2017,553,183,370,169,102,67,11,NA
"4246","TX","600","Dallas City & County, Irving CoC",3789,2702,1087,799,784,15,258,253,5,2017,542,436,106,358,297,61,46,NA
"4247","TX","601","Fort Worth, Arlington/Tarrant County CoC",1941,1551,390,597,569,28,195,184,11,2017,234,119,115,186,146,40,15,NA
"4248","TX","603","El Paso City & County CoC",1193,1016,177,502,502,0,149,149,0,2017,96,71,25,90,67,23,2,NA
"4249","TX","604","Waco/McLennan County CoC",221,162,59,96,94,2,28,27,1,2017,26,10,16,19,13,6,0,NA
"4250","TX","607","Texas Balance of State CoC",7153,3583,3570,2345,1918,427,754,600,154,2017,879,248,631,674,230,444,36,NA
"4251","TX","611","Amarillo CoC",531,419,112,56,56,0,20,20,0,2017,112,0,112,61,47,14,0,NA
"4252","TX","624","Wichita Falls/Wise, Palo Pinto, Wichita, Archer Counties CoC",234,213,21,64,64,0,23,23,0,2017,65,51,14,10,8,2,16,NA
"4253","TX","700","Houston, Pasadena, Conroe/Harris, Ft. Bend, Montgomery, Counties CoC",3605,2477,1128,935,915,20,319,310,9,2017,539,257,282,405,315,90,3,NA
"4254","TX","701","Bryan, College Station/Brazos Valley CoC",102,89,13,26,26,0,9,9,0,2017,14,6,8,0,0,0,0,NA
"4255","UT","500","Salt Lake City & County CoC",2047,1886,161,699,699,0,198,198,0,2017,143,112,31,177,170,7,6,NA
"4256","UT","503","Utah Balance of State CoC",634,558,76,218,218,0,68,68,0,2017,34,25,9,40,33,7,22,NA
"4257","UT","504","Provo/Mountainland CoC",171,130,41,53,53,0,15,15,0,2017,8,4,4,3,0,3,1,NA
"4258","VA","500","Richmond/Henrico, Chesterfield, Hanover Counties CoC",662,509,153,89,89,0,29,29,0,2017,76,35,41,94,77,17,0,NA
"4259","VA","501","Norfolk/Chesapeake, Suffolk, Isle of Wight, Southampton Counties CoC",703,634,69,131,131,0,41,41,0,2017,82,65,17,86,76,10,0,NA
"4260","VA","502","Roanoke City & County, Salem CoC",267,250,17,70,70,0,23,23,0,2017,48,43,5,32,32,0,0,NA
"4261","VA","503","Virginia Beach CoC",349,271,78,111,109,2,34,33,1,2017,62,27,35,38,28,10,12,NA
"4262","VA","504","Charlottesville CoC",160,137,23,41,41,0,11,11,0,2017,55,37,18,9,4,5,0,NA
"4263","VA","505","Newport News, Hampton/Virginia Peninsula CoC",512,432,80,160,160,0,45,45,0,2017,75,50,25,68,60,8,0,NA
"4264","VA","507","Portsmouth CoC",151,96,55,36,36,0,14,14,0,2017,12,9,3,11,7,4,0,NA
"4265","VA","508","Lynchburg CoC",125,100,25,33,33,0,10,10,0,2017,27,17,10,9,8,1,0,NA
"4266","VA","513","Harrisburg, Winchester/Western Virginia CoC",280,261,19,85,85,0,27,27,0,2017,44,38,6,10,8,2,0,NA
"4267","VA","514","Fredericksburg/Spotsylvania, Stafford Counties CoC",216,177,39,94,94,0,29,29,0,2017,29,15,14,8,8,0,0,NA
"4268","VA","521","Virginia Balance of State CoC",722,563,159,299,278,21,102,94,8,2017,39,15,24,35,26,9,0,NA
"4269","VA","600","Arlington County CoC",232,199,33,83,83,0,30,30,0,2017,63,42,21,10,9,1,0,NA
"4270","VA","601","Fairfax County CoC",964,856,108,472,469,3,142,141,1,2017,150,87,63,34,21,13,3,NA
"4271","VA","602","Loudoun County CoC",113,97,16,42,42,0,11,11,0,2017,15,8,7,6,5,1,0,NA
"4272","VA","603","Alexandria CoC",211,193,18,90,90,0,30,30,0,2017,43,29,14,6,6,0,0,NA
"4273","VA","604","Prince William County CoC",400,284,116,203,200,3,53,52,1,2017,76,14,62,22,9,13,0,NA
"4274","VT","500","Vermont Balance of State CoC",934,828,106,434,402,32,142,134,8,2017,83,62,21,69,66,3,2,NA
"4275","VT","501","Burlington/Chittenden County CoC",291,263,28,94,89,5,37,36,1,2017,44,32,12,25,23,2,0,NA
"4276","WA","500","Seattle/King County CoC",11643,6158,5485,2833,2752,81,905,883,22,2017,2773,986,1787,1329,636,693,221,NA
"4277","WA","501","Washington Balance of State CoC",5243,3563,1680,2081,1827,254,641,560,81,2017,1031,315,716,415,253,162,37,NA
"4278","WA","502","Spokane City & County CoC",1090,952,138,299,293,6,103,101,2,2017,325,239,86,118,109,9,17,NA
"4279","WA","503","Tacoma, Lakewood/Pierce County CoC",1321,817,504,442,419,23,132,125,7,2017,337,82,255,136,51,85,0,NA
"4280","WA","504","Everett/Snohomish County CoC",1066,551,515,281,237,44,90,76,14,2017,387,74,313,65,22,43,24,NA
"4281","WA","508","Vancouver/Clark County CoC",749,480,269,395,260,135,122,78,44,2017,86,51,35,30,23,7,5,NA
"4282","WI","500","Wisconsin Balance of State CoC",3348,3211,137,1849,1843,6,572,570,2,2017,232,205,27,180,171,9,1,NA
"4283","WI","501","Milwaukee City & County CoC",900,765,135,213,210,3,68,67,1,2017,98,71,27,74,65,9,21,NA
"4284","WI","502","Racine City & County CoC",194,187,7,55,55,0,17,17,0,2017,17,17,0,34,34,0,3,NA
"4285","WI","503","Madison/Dane County CoC",585,524,61,265,262,3,86,85,1,2017,87,74,13,41,39,2,3,NA
"4286","WV","500","Wheeling, Weirton Area CoC",118,111,7,41,41,0,14,14,0,2017,23,20,3,4,4,0,0,NA
"4287","WV","501","Huntington/Cabell, Wayne Counties CoC",205,173,32,57,57,0,20,20,0,2017,9,8,1,17,16,1,0,NA
"4288","WV","503","Charleston/Kanawha, Putnam, Boone, Clay Counties CoC",319,270,49,47,47,0,16,16,0,2017,65,51,14,34,31,3,7,NA
"4289","WV","508","West Virginia Balance of State CoC",667,567,100,132,116,16,45,41,4,2017,109,61,48,82,73,9,0,NA
"4290","WY","500","Wyoming Statewide CoC",873,510,363,251,127,124,96,55,41,2017,68,26,42,63,50,13,19,NA
"4291",NA,NA,"Total",550996,360867,190129,184411,167723,16688,57886,52829,5057,2017,95092,32609,62483,40020,24690,15330,4635,NA
"4292","AK","500","Anchorage CoC",1094,1000,94,280,280,0,87,87,0,2018,177,150,27,62,58,4,5,"Other Urban CoCs"
"4293","AK","501","Alaska Balance of State CoC",922,707,215,302,254,48,106,88,18,2018,180,125,55,70,52,18,3,"Rural CoCs"
"4294","AL","500","Birmingham/Jefferson, St. Clair, Shelby Counties CoC",901,682,219,181,181,0,54,54,0,2018,119,95,24,133,116,17,4,"Suburban CoCs"
"4295","AL","501","Mobile City & County/Baldwin County CoC",551,318,233,152,135,17,48,42,6,2018,59,11,48,52,42,10,0,"Other Urban CoCs"
"4296","AL","502","Florence/Northwest Alabama CoC",256,234,22,90,90,0,41,41,0,2018,136,122,14,8,0,8,16,"Rural CoCs"
"4297","AL","503","Huntsville/North Alabama CoC",424,308,116,88,78,10,30,27,3,2018,111,57,54,34,21,13,5,"Other Urban CoCs"
"4298","AL","504","Montgomery City & County CoC",369,300,69,97,97,0,28,28,0,2018,63,41,22,54,48,6,9,"Other Urban CoCs"
"4299","AL","505","Gadsden/Northeast Alabama CoC",146,86,60,27,27,0,8,8,0,2018,35,7,28,8,5,3,8,"Rural CoCs"
"4300","AL","506","Tuscaloosa City & County CoC",57,56,1,22,22,0,8,8,0,2018,4,4,0,10,10,0,0,"Other Urban CoCs"
"4301","AL","507","Alabama Balance of State CoC",730,440,290,207,101,106,63,35,28,2018,13,4,9,40,25,15,2,"Rural CoCs"
"4302","AR","500","Little Rock/Central Arkansas CoC",1081,531,550,131,99,32,47,35,12,2018,232,82,150,124,70,54,14,"Other Urban CoCs"
"4303","AR","501","Fayetteville/Northwest Arkansas CoC",474,323,151,126,126,0,42,42,0,2018,42,9,33,60,40,20,22,"Other Urban CoCs"
"4304","AR","503","Arkansas  Balance of State  CoC",768,309,459,102,85,17,35,30,5,2018,107,21,86,31,14,17,0,"Rural CoCs"
"4305","AR","504","Delta Hills CoC",57,32,25,6,0,6,2,0,2,2018,18,9,9,11,11,0,0,"Rural CoCs"
"4306","AR","505","Southeast Arkansas CoC",101,95,6,48,48,0,14,14,0,2018,0,0,0,3,3,0,7,"Rural CoCs"
"4307","AR","508","Fort Smith CoC",231,165,66,19,16,3,7,6,1,2018,67,32,35,22,12,10,0,"Rural CoCs"
"4308","AR","512","Boone, Baxter, Marion, Newton Counties CoC",NA,NA,NA,NA,NA,NA,NA,NA,NA,2018,NA,NA,NA,NA,NA,NA,NA,"Rural CoCs"
"4309","AZ","500","Arizona Balance of State CoC",2187,1102,1085,549,438,111,169,138,31,2018,537,59,478,277,107,170,10,"Rural CoCs"
"4310","AZ","501","Tucson/Pima County CoC",1380,1017,363,301,297,4,104,102,2,2018,263,172,91,203,158,45,0,"Major Cities"
"4311","AZ","502","Phoenix, Mesa/Maricopa County CoC",6298,3680,2618,1756,1710,46,519,505,14,2018,974,358,616,413,275,138,38,"Major Cities"
"4312","CA","500","San Jose/Santa Clara City & County CoC",7254,1806,5448,987,691,296,272,201,71,2018,2139,344,1795,658,206,452,506,"Major Cities"
"4313","CA","501","San Francisco CoC",6857,2504,4353,646,626,20,247,241,6,2018,1757,179,1578,656,300,356,103,"Major Cities"
"4314","CA","502","Oakland, Berkeley/Alameda County CoC",5496,1633,3863,695,669,26,256,247,9,2018,1742,333,1409,526,148,378,74,"Major Cities"
"4315","CA","503","Sacramento City & County CoC",3621,1569,2052,517,500,17,161,155,6,2018,1192,389,803,492,165,327,2,"Major Cities"
"4316","CA","504","Santa Rosa, Petaluma/Sonoma County CoC",2996,1067,1929,339,307,32,104,91,13,2018,747,115,632,207,63,144,34,"Suburban CoCs"
"4317","CA","505","Richmond/Contra Costa County CoC",2234,697,1537,279,174,105,89,55,34,2018,555,186,369,102,56,46,0,"Suburban CoCs"
"4318","CA","506","Salinas/Monterey, San Benito Counties CoC",3299,785,2514,616,400,216,173,118,55,2018,942,83,859,167,111,56,152,"Rural CoCs"
"4319","CA","507","Marin County CoC",1095,387,708,175,145,30,58,50,8,2018,399,107,292,89,22,67,18,"Suburban CoCs"
"4320","CA","508","Watsonville/Santa Cruz City & County CoC",2320,521,1799,409,240,169,134,80,54,2018,634,111,523,245,28,217,169,"Suburban CoCs"
"4321","CA","509","Mendocino County CoC",880,157,723,51,51,0,14,14,0,2018,96,43,53,12,6,6,0,"Rural CoCs"
"4322","CA","510","Turlock, Modesto/Stanislaus County CoC",1356,750,606,276,243,33,85,75,10,2018,241,108,133,87,45,42,3,"Suburban CoCs"
"4323","CA","511","Stockton/San Joaquin County CoC",1685,1118,567,631,613,18,187,182,5,2018,262,138,124,96,64,32,3,"Other Urban CoCs"
"4324","CA","512","Daly/San Mateo County CoC",1238,601,637,427,352,75,121,102,19,2018,238,35,203,100,43,57,5,"Suburban CoCs"
"4325","CA","513","Visalia/Kings, Tulare Counties CoC",967,315,652,144,130,14,45,40,5,2018,288,14,274,46,6,40,3,"Other Urban CoCs"
"4326","CA","514","Fresno City & County/Madera County CoC",2144,463,1681,258,249,9,84,81,3,2018,524,42,482,211,86,125,12,"Major Cities"
"4327","CA","515","Roseville, Rocklin/Placer, Nevada Counties CoC",950,492,458,184,161,23,58,50,8,2018,327,162,165,55,31,24,0,"Suburban CoCs"
"4328","CA","516","Redding/Shasta, Siskiyou, Lassen, Plumas, Del Norte, Modoc, Sierra Counties CoC",1149,459,690,194,120,74,56,34,22,2018,431,107,324,124,56,68,5,"Rural CoCs"
"4329","CA","517","Napa City & County CoC",322,168,154,46,43,3,14,13,1,2018,158,66,92,23,13,10,0,"Other Urban CoCs"
"4330","CA","518","Vallejo/Solano County CoC",1129,212,917,77,46,31,28,19,9,2018,461,87,374,124,19,105,18,"Other Urban CoCs"
"4331","CA","519","Chico, Paradise/Butte County CoC",1125,380,745,179,122,57,61,43,18,2018,506,86,420,109,29,80,12,"Rural CoCs"
"4332","CA","520","Merced City & County CoC",514,202,312,58,47,11,17,13,4,2018,148,18,130,13,3,10,0,"Suburban CoCs"
"4333","CA","521","Davis, Woodland/Yolo County CoC",448,239,209,132,127,5,48,47,1,2018,157,10,147,22,4,18,0,"Suburban CoCs"
"4334","CA","522","Humboldt County CoC",703,269,434,98,65,33,32,21,11,2018,363,95,268,106,66,40,13,"Rural CoCs"
"4335","CA","523","Colusa, Glenn, Trinity Counties CoC",268,95,173,106,85,21,33,24,9,2018,94,1,93,18,2,16,3,"Rural CoCs"
"4336","CA","524","Yuba City & County/Sutter County CoC",765,292,473,308,220,88,96,67,29,2018,172,96,76,28,1,27,1,"Suburban CoCs"
"4337","CA","525","El Dorado County CoC",645,149,496,168,30,138,65,12,53,2018,211,0,211,82,0,82,12,"Suburban CoCs"
"4338","CA","526","Amador, Calaveras, Mariposa, Tuolumne Counties CoC",398,134,264,133,89,44,45,29,16,2018,72,5,67,19,9,10,0,"Rural CoCs"
"4339","CA","527","Tehama County CoC",125,69,56,18,18,0,6,6,0,2018,55,18,37,9,8,1,0,"Rural CoCs"
"4340","CA","529","Lake County CoC",615,24,591,68,11,57,30,5,25,2018,82,4,78,12,1,11,6,"Rural CoCs"
"4341","CA","530","Alpine, Inyo, Mono Counties CoC",157,1,156,12,0,12,3,0,3,2018,65,1,64,6,0,6,0,"Rural CoCs"
"4342","CA","600","Los Angeles City & County CoC",49955,12385,37570,7876,6210,1666,2528,1971,557,2018,13275,853,12422,3538,871,2667,63,"Major Cities"
"4343","CA","601","San Diego City and County CoC",8576,3586,4990,1513,1199,314,483,381,102,2018,2171,771,1400,1312,653,659,105,"Major Cities"
"4344","CA","602","Santa Ana, Anaheim/Orange County CoC",4955,2371,2584,1175,1109,66,371,351,20,2018,1066,457,609,419,62,357,9,"Suburban CoCs"
"4345","CA","603","Santa Maria/Santa Barbara County CoC",1706,813,893,371,217,154,117,69,48,2018,307,207,100,104,55,49,34,"Suburban CoCs"
"4346","CA","604","Bakersfield/Kern County CoC",885,515,370,170,162,8,56,53,3,2018,133,35,98,80,62,18,0,"Other Urban CoCs"
"4347","CA","606","Long Beach CoC",1873,665,1208,195,138,57,66,47,19,2018,587,41,546,305,195,110,0,"Major Cities"
"4348","CA","607","Pasadena CoC",677,215,462,104,81,23,37,29,8,2018,164,74,90,31,8,23,0,"Other Urban CoCs"
"4349","CA","608","Riverside City & County CoC",2316,631,1685,229,220,9,69,65,4,2018,474,87,387,136,37,99,12,"Suburban CoCs"
"4350","CA","609","San Bernardino City & County CoC",2118,675,1443,525,422,103,153,124,29,2018,423,44,379,170,45,125,7,"Suburban CoCs"
"4351","CA","611","Oxnard, San Buenaventura/Ventura County CoC",1308,478,830,199,178,21,74,68,6,2018,280,51,229,62,23,39,1,"Other Urban CoCs"
"4352","CA","612","Glendale CoC",260,104,156,92,75,17,30,24,6,2018,49,11,38,12,0,12,0,"Other Urban CoCs"
"4353","CA","613","Imperial County CoC",1493,160,1333,182,120,62,58,42,16,2018,44,1,43,130,3,127,12,"Suburban CoCs"
"4354","CA","614","San Luis Obispo County CoC",1095,273,822,102,89,13,38,33,5,2018,301,35,266,93,17,76,29,"Suburban CoCs"
"4355","CO","500","Colorado Balance of State CoC",3989,1481,2508,1443,535,908,430,163,267,2018,797,218,579,315,124,191,16,"Rural CoCs"
"4356","CO","503","Metropolitan Denver CoC",5317,4009,1308,1402,1309,93,432,404,28,2018,1596,852,744,566,422,144,5,"Major Cities"
"4357","CO","504","Colorado Springs/El Paso County CoC",1551,1038,513,405,382,23,128,122,6,2018,345,90,255,192,111,81,1,"Major Cities"
"4358","CT","503","Bridgeport, Stamford, Norwalk/Fairfield County CoC",741,659,82,309,309,0,108,108,0,2018,52,43,9,41,40,1,5,"Other Urban CoCs"
"4359","CT","505","Connecticut Balance of State CoC",3235,2736,499,1387,1387,0,445,445,0,2018,289,195,94,149,137,12,2,"Suburban CoCs"
"4360","DE","500","Delaware Statewide CoC",1082,989,93,374,374,0,125,125,0,2018,189,170,19,70,67,3,1,"Suburban CoCs"
"4361","FL","500","Sarasota, Bradenton/Manatee, Sarasota Counties CoC",1192,740,452,238,221,17,76,71,5,2018,250,69,181,108,59,49,16,"Suburban CoCs"
"4362","FL","501","Tampa/Hillsborough County CoC",1795,1155,640,602,575,27,174,167,7,2018,262,72,190,171,119,52,0,"Suburban CoCs"
"4363","FL","502","St. Petersburg, Clearwater, Largo/Pinellas County CoC",2612,1647,965,359,357,2,110,109,1,2018,434,99,335,281,233,48,37,"Suburban CoCs"
"4364","FL","503","Lakeland, Winterhaven/Polk County CoC",552,418,134,198,198,0,52,52,0,2018,84,21,63,26,16,10,6,"Suburban CoCs"
"4365","FL","504","Daytona Beach, Daytona/Volusia, Flagler Counties CoC",683,277,406,199,178,21,58,53,5,2018,90,8,82,44,15,29,0,"Suburban CoCs"
"4366","FL","505","Fort Walton Beach/Okaloosa, Walton Counties CoC",495,83,412,147,61,86,45,19,26,2018,119,1,118,30,2,28,0,"Suburban CoCs"
"4367","FL","506","Tallahassee/Leon County CoC",909,810,99,269,262,7,81,78,3,2018,151,100,51,108,89,19,10,"Other Urban CoCs"
"4368","FL","507","Orlando/Orange, Osceola, Seminole Counties CoC",2053,1693,360,713,691,22,215,209,6,2018,272,119,153,181,156,25,0,"Suburban CoCs"
"4369","FL","508","Gainesville/Alachua, Putnam Counties CoC",756,323,433,113,83,30,35,26,9,2018,272,43,229,114,66,48,37,"Rural CoCs"
"4370","FL","509","Fort Pierce/St. Lucie, Indian River, Martin Counties CoC",1542,513,1029,688,453,235,200,136,64,2018,56,0,56,61,2,59,8,"Suburban CoCs"
"4371","FL","510","Jacksonville-Duval, Clay Counties CoC",1794,1365,429,384,384,0,126,126,0,2018,327,198,129,121,92,29,17,"Major Cities"
"4372","FL","511","Pensacola/Escambia, Santa Rosa Counties CoC",632,487,145,165,158,7,44,41,3,2018,78,31,47,103,84,19,1,"Suburban CoCs"
"4373","FL","512","St. Johns County CoC",342,178,164,123,123,0,35,35,0,2018,65,6,59,30,6,24,0,"Suburban CoCs"
"4374","FL","513","Palm Bay, Melbourne/Brevard County CoC",734,481,253,213,198,15,69,64,5,2018,116,2,114,169,130,39,60,"Suburban CoCs"
"4375","FL","514","Ocala/Marion County CoC",572,301,271,129,113,16,38,34,4,2018,124,23,101,69,69,0,15,"Suburban CoCs"
"4376","FL","515","Panama City/Bay, Jackson Counties CoC",381,109,272,68,34,34,21,9,12,2018,98,0,98,34,9,25,5,"Rural CoCs"
"4377","FL","517","Hendry, Hardee, Highlands Counties CoC",453,69,384,161,53,108,44,25,19,2018,259,11,248,18,0,18,31,"Rural CoCs"
"4378","FL","518","Columbia, Hamilton, Lafayette, Suwannee Counties CoC",493,90,403,106,29,77,37,9,28,2018,38,0,38,41,24,17,9,"Rural CoCs"
"4379","FL","519","Pasco County CoC",2668,253,2415,1839,149,1690,467,45,422,2018,826,30,796,214,39,175,58,"Suburban CoCs"
"4380","FL","520","Citrus, Hernando, Lake, Sumter Counties CoC",711,449,262,285,266,19,84,77,7,2018,36,11,25,45,27,18,0,"Suburban CoCs"
"4381","FL","600","Miami-Dade County CoC",3516,2486,1030,1091,1091,0,312,312,0,2018,384,236,148,120,111,9,25,"Major Cities"
"4382","FL","601","Ft Lauderdale/Broward County CoC",2318,1449,869,462,436,26,131,123,8,2018,439,207,232,189,116,73,14,"Suburban CoCs"
"4383","FL","602","Punta Gorda/Charlotte County CoC",164,78,86,34,24,10,8,7,1,2018,45,11,34,40,39,1,0,"Suburban CoCs"
"4384","FL","603","Ft Myers, Cape Coral/Lee County CoC",728,524,204,305,274,31,80,73,7,2018,132,32,100,18,7,11,10,"Suburban CoCs"
"4385","FL","604","Monroe County CoC",973,761,212,249,214,35,74,64,10,2018,62,37,25,67,22,45,12,"Rural CoCs"
"4386","FL","605","West Palm Beach/Palm Beach County CoC",1309,458,851,345,262,83,108,84,24,2018,164,22,142,130,47,83,4,"Suburban CoCs"
"4387","FL","606","Naples/Collier County CoC",653,440,213,102,64,38,33,22,11,2018,119,59,60,11,3,8,66,"Suburban CoCs"
"4388","GA","500","Atlanta CoC",3076,2336,740,540,532,8,166,163,3,2018,335,105,230,399,303,96,9,"Major Cities"
"4389","GA","501","Georgia Balance of State CoC",3730,1857,1873,1328,1159,169,434,365,69,2018,266,98,168,167,50,117,3,"Rural CoCs"
"4390","GA","502","Fulton County CoC",222,134,88,107,85,22,40,29,11,2018,86,20,66,12,12,0,15,"Suburban CoCs"
"4391","GA","503","Athens-Clarke County CoC",212,166,46,84,84,0,23,23,0,2018,37,14,23,14,10,4,0,"Other Urban CoCs"
"4392","GA","504","Augusta-Richmond County CoC",269,222,47,31,31,0,11,11,0,2018,18,16,2,29,24,5,0,"Other Urban CoCs"
"4393","GA","505","Columbus-Muscogee/Russell County CoC",276,196,80,42,42,0,11,11,0,2018,28,10,18,13,3,10,0,"Other Urban CoCs"
"4394","GA","506","Marietta/Cobb County CoC",384,266,118,139,125,14,44,40,4,2018,41,8,33,25,11,14,0,"Suburban CoCs"
"4395","GA","507","Savannah/Chatham County CoC",1009,545,464,134,134,0,35,35,0,2018,223,41,182,38,16,22,0,"Other Urban CoCs"
"4396","GA","508","DeKalb County CoC",321,178,143,151,151,0,48,48,0,2018,46,12,34,8,0,8,2,"Suburban CoCs"
"4397","HI","500","Hawaii Balance of State CoC",2035,705,1330,809,479,330,216,135,81,2018,597,61,536,125,28,97,1,"Rural CoCs"
"4398","HI","501","Honolulu City and County CoC",4495,2350,2145,1590,1361,229,407,340,67,2018,1117,197,920,407,212,195,10,"Suburban CoCs"
"4399","IA","500","Sioux City/Dakota, Woodbury Counties CoC",264,258,6,92,92,0,29,29,0,2018,27,24,3,25,24,1,0,"Other Urban CoCs"
"4400","IA","501","Iowa Balance of State CoC",1721,1593,128,794,773,21,247,242,5,2018,133,118,15,79,73,6,9,"Rural CoCs"
"4401","IA","502","Des Moines/Polk County CoC",764,657,107,152,152,0,49,49,0,2018,110,64,46,92,80,12,3,"Other Urban CoCs"
"4402","ID","500","Boise/Ada County CoC",756,635,121,143,143,0,44,44,0,2018,182,127,55,113,98,15,4,"Other Urban CoCs"
"4403","ID","501","Idaho Balance of State CoC",1256,654,602,572,374,198,165,114,51,2018,142,39,103,102,48,54,7,"Rural CoCs"
"4404","IL","500","McHenry County CoC",179,174,5,55,55,0,20,20,0,2018,23,19,4,39,39,0,1,"Suburban CoCs"
"4405","IL","501","Rockford/Winnebago, Boone Counties CoC",256,213,43,87,87,0,30,30,0,2018,18,0,18,21,16,5,2,"Suburban CoCs"
"4406","IL","502","Waukegan, North Chicago/Lake County CoC",277,253,24,116,116,0,38,38,0,2018,33,26,7,13,13,0,0,"Suburban CoCs"
"4407","IL","503","Champaign, Urbana, Rantoul/Champaign County CoC",188,179,9,67,67,0,20,20,0,2018,9,8,1,7,6,1,2,"Other Urban CoCs"
"4408","IL","504","Madison County CoC",146,95,51,58,51,7,17,15,2,2018,22,3,19,5,3,2,3,"Suburban CoCs"
"4409","IL","506","Joliet, Bolingbrook/Will County CoC",341,298,43,160,160,0,50,50,0,2018,23,10,13,16,15,1,0,"Suburban CoCs"
"4410","IL","507","Peoria, Pekin/Fulton, Tazewell, Peoria, Woodford Counties CoC",400,366,34,152,150,2,41,40,1,2018,54,47,7,37,31,6,0,"Suburban CoCs"
"4411","IL","508","East St. Louis, Belleville/St. Clair County CoC",250,160,90,126,99,27,40,34,6,2018,26,10,16,29,24,5,0,"Suburban CoCs"
"4412","IL","509","Dekalb City & County CoC",100,97,3,55,55,0,19,19,0,2018,7,4,3,5,5,0,0,"Suburban CoCs"
"4413","IL","510","Chicago CoC",5450,4093,1357,1897,1890,7,561,558,3,2018,971,436,535,494,296,198,7,"Major Cities"
"4414","IL","511","Cook County CoC",873,781,92,314,311,3,105,104,1,2018,134,111,23,50,47,3,1,"Suburban CoCs"
"4415","IL","512","Bloomington/Central Illinois CoC",387,362,25,139,137,2,52,51,1,2018,43,31,12,10,9,1,23,"Rural CoCs"
"4416","IL","513","Springfield/Sangamon County CoC",271,252,19,76,74,2,27,26,1,2018,32,26,6,18,18,0,0,"Other Urban CoCs"
"4417","IL","514","DuPage County CoC",295,280,15,124,124,0,45,45,0,2018,31,28,3,12,12,0,6,"Suburban CoCs"
"4418","IL","515","South Central Illinois CoC",92,70,22,48,45,3,17,16,1,2018,5,1,4,3,1,2,0,"Rural CoCs"
"4419","IL","516","Decatur/Macon County CoC",161,140,21,63,60,3,18,17,1,2018,16,13,3,4,4,0,0,"Other Urban CoCs"
"4420","IL","517","Aurora, Elgin/Kane County CoC",430,405,25,112,112,0,32,32,0,2018,145,130,15,22,22,0,1,"Suburban CoCs"
"4421","IL","518","Rock Island, Moline/Northwestern Illinois CoC",198,182,16,60,60,0,22,22,0,2018,0,0,0,8,8,0,0,"Rural CoCs"
"4422","IL","519","West Central Illinois CoC",67,67,0,44,44,0,14,14,0,2018,2,2,0,0,0,0,1,"Rural CoCs"
"4423","IL","520","Southern Illinois CoC",282,234,48,138,128,10,55,52,3,2018,31,16,15,11,5,6,1,"Rural CoCs"
"4424","IN","502","Indiana Balance of State CoC",3576,3133,443,1099,1091,8,353,350,3,2018,244,243,1,278,242,36,21,"Rural CoCs"
"4425","IN","503","Indianapolis CoC",1682,1546,136,383,383,0,128,128,0,2018,205,159,46,261,249,12,0,"Major Cities"
"4426","KS","502","Wichita/Sedgwick County CoC",573,515,58,152,152,0,45,45,0,2018,33,20,13,58,54,4,4,"Major Cities"
"4427","KS","503","Topeka/Shawnee County CoC",408,347,61,126,126,0,38,38,0,2018,141,94,47,58,49,9,0,"Other Urban CoCs"
"4428","KS","505","Overland Park, Shawnee/Johnson County CoC",168,130,38,104,102,2,30,29,1,2018,19,9,10,5,1,4,0,"Suburban CoCs"
"4429","KS","507","Kansas Balance of State CoC",918,757,161,337,337,0,91,91,0,2018,82,56,26,58,52,6,3,"Rural CoCs"
"4430","KY","500","Kentucky Balance of State CoC",2077,1385,692,625,541,84,182,159,23,2018,142,80,62,148,102,46,5,"Rural CoCs"
"4431","KY","501","Louisville-Jefferson County CoC",926,773,153,223,218,5,69,68,1,2018,129,108,21,129,115,14,11,"Major Cities"
"4432","KY","502","Lexington-Fayette County CoC",685,662,23,105,105,0,35,35,0,2018,98,91,7,92,91,1,3,"Other Urban CoCs"
"4433","LA","500","Lafayette/Acadiana CoC",363,190,173,79,77,2,24,23,1,2018,64,18,46,26,20,6,0,"Rural CoCs"
"4434","LA","502","Shreveport, Bossier/Northwest Louisiana CoC",375,331,44,104,104,0,32,32,0,2018,55,35,20,100,98,2,3,"Other Urban CoCs"
"4435","LA","503","New Orleans/Jefferson Parish CoC",1188,594,594,131,124,7,42,40,2,2018,193,45,148,109,94,15,2,"Major Cities"
"4436","LA","505","Monroe/Northeast Louisiana CoC",187,179,8,111,106,5,34,33,1,2018,10,7,3,7,6,1,0,"Rural CoCs"
"4437","LA","506","Slidell/Southeast Louisiana CoC",194,135,59,20,15,5,7,5,2,2018,25,2,23,42,35,7,0,"Suburban CoCs"
"4438","LA","507","Alexandria/Central Louisiana CoC",177,124,53,25,25,0,9,9,0,2018,28,10,18,26,24,2,0,"Rural CoCs"
"4439","LA","509","Louisiana Balance of State CoC",575,441,134,49,41,8,16,14,2,2018,101,39,62,96,85,11,23,"Suburban CoCs"
"4440","MA","500","Boston CoC",6188,6025,163,3653,3653,0,1121,1121,0,2018,724,695,29,275,268,7,0,"Major Cities"
"4441","MA","502","Lynn CoC",1061,1019,42,933,933,0,390,390,0,2018,66,38,28,5,4,1,0,"Suburban CoCs"
"4442","MA","503","Cape Cod Islands CoC",358,319,39,184,182,2,70,69,1,2018,56,28,28,12,8,4,0,"Suburban CoCs"
"4443","MA","504","Springfield/Hampden County CoC",3368,3324,44,2911,2911,0,802,802,0,2018,206,188,18,19,16,3,0,"Suburban CoCs"
"4444","MA","505","New Bedford CoC",409,360,49,187,187,0,57,57,0,2018,29,12,17,52,50,2,2,"Suburban CoCs"
"4445","MA","506","Worcester City & County CoC",1852,1682,170,1088,1088,0,321,321,0,2018,133,70,63,215,206,9,0,"Suburban CoCs"
"4446","MA","507","Pittsfield/Berkshire, Franklin, Hampshire Counties CoC",651,597,54,245,245,0,66,66,0,2018,72,67,5,192,188,4,0,"Suburban CoCs"
"4447","MA","508","Lowell CoC",783,757,26,565,565,0,166,166,0,2018,75,75,0,30,28,2,0,"Suburban CoCs"
"4448","MA","509","Cambridge CoC",561,482,79,158,158,0,60,60,0,2018,194,159,35,15,10,5,0,"Other Urban CoCs"
"4449","MA","510","Gloucester, Haverhill, Salem/Essex County CoC",732,689,43,492,492,0,161,161,0,2018,75,75,0,30,30,0,0,"Suburban CoCs"
"4450","MA","511","Quincy, Brockton, Weymouth, Plymouth City and County CoC",1090,1068,22,755,755,0,252,252,0,2018,180,165,15,46,46,0,0,"Suburban CoCs"
"4451","MA","515","Fall River CoC",377,345,32,275,275,0,88,88,0,2018,63,54,9,3,1,2,0,"Suburban CoCs"
"4452","MA","516","Massachusetts Balance of State CoC",2296,2126,170,1651,1651,0,547,547,0,2018,205,158,47,65,56,9,1,"Suburban CoCs"
"4453","MA","517","Somerville CoC",134,124,10,34,34,0,14,14,0,2018,11,11,0,22,22,0,0,"Suburban CoCs"
"4454","MA","519","Attleboro, Taunton/Bristol County CoC",208,166,42,126,126,0,34,34,0,2018,33,8,25,4,1,3,0,"Suburban CoCs"
"4455","MD","500","Cumberland/Allegany County CoC",79,55,24,41,38,3,15,14,1,2018,5,0,5,1,0,1,0,"Suburban CoCs"
"4456","MD","501","Baltimore CoC",2508,1962,546,391,391,0,131,131,0,2018,592,302,290,295,271,24,5,"Major Cities"
"4457","MD","502","Harford County CoC",190,169,21,90,90,0,26,26,0,2018,46,33,13,7,6,1,0,"Suburban CoCs"
"4458","MD","503","Annapolis/Anne Arundel County CoC",366,280,86,100,97,3,33,32,1,2018,85,48,37,24,16,8,0,"Suburban CoCs"
"4459","MD","504","Howard County CoC",168,125,43,77,74,3,23,22,1,2018,37,15,22,6,1,5,2,"Suburban CoCs"
"4460","MD","505","Baltimore County CoC",758,472,286,329,269,60,100,84,16,2018,189,59,130,37,16,21,0,"Suburban CoCs"
"4461","MD","506","Carroll County CoC",173,151,22,73,73,0,18,18,0,2018,31,28,3,6,4,2,0,"Suburban CoCs"
"4462","MD","507","Cecil County CoC",129,88,41,39,39,0,11,11,0,2018,22,0,22,45,37,8,0,"Suburban CoCs"
"4463","MD","508","Charles, Calvert, St.Mary's Counties CoC",492,206,286,218,82,136,61,29,32,2018,87,18,69,27,8,19,0,"Suburban CoCs"
"4464","MD","509","Frederick City & County CoC",316,232,84,109,109,0,36,36,0,2018,52,34,18,9,7,2,0,"Suburban CoCs"
"4465","MD","510","Garrett County CoC",15,15,0,7,7,0,3,3,0,2018,0,0,0,0,0,0,0,"Rural CoCs"
"4466","MD","511","Mid-Shore Regional CoC",141,111,30,63,50,13,20,16,4,2018,19,10,9,9,8,1,0,"Rural CoCs"
"4467","MD","512","Hagerstown/Washington County CoC",199,154,45,50,41,9,17,14,3,2018,45,22,23,38,36,2,0,"Suburban CoCs"
"4468","MD","513","Wicomico, Somerset, Worcester Counties CoC",292,260,32,98,93,5,32,31,1,2018,56,41,15,23,21,2,0,"Rural CoCs"
"4469","MD","600","Prince George's County CoC",478,393,85,273,273,0,88,88,0,2018,19,16,3,29,21,8,2,"Suburban CoCs"
"4470","MD","601","Montgomery County CoC",840,707,133,272,272,0,85,85,0,2018,124,94,30,18,18,0,0,"Suburban CoCs"
"4471","ME","500","Maine Statewide CoC",2516,2418,98,1066,1059,7,341,339,2,2018,215,214,1,119,106,13,13,"Rural CoCs"
"4472","MI","500","Michigan Balance of State CoC",1343,1152,191,624,587,37,190,178,12,2018,53,36,17,70,62,8,22,"Rural CoCs"
"4473","MI","501","Detroit CoC",1769,1611,158,501,497,4,167,166,1,2018,221,154,67,322,305,17,4,"Major Cities"
"4474","MI","502","Dearborn, Dearborn Heights, Westland/Wayne County CoC",211,198,13,137,137,0,38,38,0,2018,16,16,0,12,12,0,0,"Suburban CoCs"
"4475","MI","503","St. Clair Shores, Warren/Macomb County CoC",270,242,28,73,73,0,27,27,0,2018,27,27,0,16,16,0,11,"Suburban CoCs"
"4476","MI","504","Pontiac, Royal Oak/Oakland County CoC",427,356,71,134,134,0,39,39,0,2018,42,32,10,8,8,0,7,"Suburban CoCs"
"4477","MI","505","Flint/Genesee County CoC",438,338,100,153,144,9,45,41,4,2018,30,21,9,17,12,5,20,"Suburban CoCs"
"4478","MI","506","Grand Rapids, Wyoming/Kent County CoC",723,675,48,274,264,10,73,70,3,2018,102,97,5,68,65,3,2,"Other Urban CoCs"
"4479","MI","507","Portage, Kalamazoo City & County CoC",567,514,53,224,222,2,74,73,1,2018,129,107,22,24,20,4,7,"Other Urban CoCs"
"4480","MI","508","Lansing, East Lansing/Ingham County CoC",419,380,39,125,125,0,37,37,0,2018,43,38,5,30,28,2,5,"Other Urban CoCs"
"4481","MI","509","Washtenaw County CoC",282,255,27,72,72,0,23,23,0,2018,45,36,9,26,25,1,3,"Suburban CoCs"
"4482","MI","510","Saginaw City & County CoC",357,345,12,204,204,0,61,61,0,2018,10,10,0,12,11,1,3,"Suburban CoCs"
"4483","MI","511","Lenawee County CoC",117,117,0,63,63,0,22,22,0,2018,5,5,0,0,0,0,0,"Rural CoCs"
"4484","MI","512","Grand Traverse, Antrim, Leelanau Counties CoC",235,212,23,66,66,0,18,18,0,2018,48,36,12,12,11,1,3,"Rural CoCs"
"4485","MI","513","Marquette, Alger Counties CoC",70,61,9,36,36,0,12,12,0,2018,4,3,1,1,1,0,0,"Rural CoCs"
"4486","MI","514","Battle Creek/Calhoun County CoC",236,195,41,64,64,0,19,19,0,2018,25,16,9,44,41,3,2,"Other Urban CoCs"
"4487","MI","515","Monroe City & County CoC",209,199,10,74,71,3,20,19,1,2018,24,18,6,11,11,0,3,"Suburban CoCs"
"4488","MI","516","Norton Shores, Muskegon City & County CoC",159,125,34,53,45,8,21,18,3,2018,19,12,7,4,4,0,0,"Suburban CoCs"
"4489","MI","517","Jackson City & County CoC",81,72,9,16,16,0,6,6,0,2018,10,8,2,6,5,1,0,"Rural CoCs"
"4490","MI","518","Livingston County CoC",90,78,12,44,39,5,13,12,1,2018,0,0,0,5,4,1,4,"Suburban CoCs"
"4491","MI","519","Holland/Ottawa County CoC",226,210,16,93,91,2,30,29,1,2018,4,2,2,5,5,0,0,"Suburban CoCs"
"4492","MI","523","Eaton County CoC",122,117,5,112,112,0,30,30,0,2018,4,3,1,0,0,0,0,"Suburban CoCs"
"4493","MN","500","Minneapolis/Hennepin County CoC",3013,2609,404,1321,1321,0,348,348,0,2018,490,360,130,138,116,22,26,"Major Cities"
"4494","MN","501","Saint Paul/Ramsey County CoC",1424,1295,129,538,519,19,176,171,5,2018,235,179,56,60,57,3,19,"Other Urban CoCs"
"4495","MN","502","Rochester/Southeast Minnesota CoC",497,431,66,265,258,7,78,76,2,2018,32,19,13,13,10,3,1,"Rural CoCs"
"4496","MN","503","Dakota, Anoka, Washington, Scott, Carver Counties",625,413,212,280,215,65,93,72,21,2018,78,42,36,21,18,3,11,"Suburban CoCs"
"4497","MN","504","Northeast Minnesota CoC",90,47,43,33,21,12,11,8,3,2018,12,5,7,4,1,3,0,"Rural CoCs"
"4498","MN","505","St. Cloud/Central Minnesota CoC",584,479,105,306,287,19,104,99,5,2018,64,40,24,38,25,13,3,"Rural CoCs"
"4499","MN","506","Northwest Minnesota CoC",274,266,8,165,165,0,55,55,0,2018,22,19,3,4,4,0,7,"Rural CoCs"
"4500","MN","508","Moorhead/West Central Minnesota CoC",246,240,6,134,134,0,40,40,0,2018,25,21,4,10,9,1,4,"Rural CoCs"
"4501","MN","509","Duluth/St.Louis County CoC",425,277,148,164,139,25,58,50,8,2018,108,27,81,12,9,3,25,"Rural CoCs"
"4502","MN","511","Southwest Minnesota CoC",65,65,0,44,44,0,16,16,0,2018,0,0,0,1,1,0,0,"Rural CoCs"
"4503","MO","500","St. Louis County CoC",450,424,26,192,192,0,72,72,0,2018,45,38,7,16,14,2,25,"Suburban CoCs"
"4504","MO","501","St.Louis City CoC",949,852,97,330,330,0,112,112,0,2018,95,74,21,136,132,4,1,"Other Urban CoCs"
"4505","MO","503","St. Charles City & County, Lincoln, Warren Counties CoC",532,370,162,254,245,9,92,89,3,2018,33,14,19,9,4,5,5,"Suburban CoCs"
"4506","MO","600","Springfield/Greene, Christian, Webster Counties CoC",479,282,197,165,157,8,54,51,3,2018,135,58,77,28,5,23,13,"Other Urban CoCs"
"4507","MO","602","Joplin/Jasper, Newton Counties CoC",275,220,55,48,45,3,19,18,1,2018,32,22,10,65,54,11,6,"Rural CoCs"
"4508","MO","603","St. Joseph/Andrew, Buchanan, DeKalb Counties CoC",204,174,30,101,101,0,33,33,0,2018,62,41,21,14,12,2,0,"Other Urban CoCs"
"4509","MO","604a","Kansas City, Independence, Lee’s Summit/Jackson, Wyandotte Counties, MO & KS",1798,1474,324,598,580,18,187,183,4,2018,416,246,170,143,108,35,15,"Major Cities"
"4510","MO","606","Missouri Balance of State CoC",1345,983,362,473,430,43,150,138,12,2018,250,174,76,112,97,15,35,"Rural CoCs"
"4511","MS","500","Jackson/Rankin, Madison Counties CoC",446,309,137,84,84,0,36,36,0,2018,172,47,125,44,10,34,6,"Suburban CoCs"
"4512","MS","501","Mississippi Balance of State CoC",560,297,263,156,98,58,50,33,17,2018,58,13,45,43,27,16,2,"Rural CoCs"
"4513","MS","503","Gulf Port/Gulf Coast Regional CoC",346,125,221,88,88,0,26,26,0,2018,49,0,49,15,0,15,0,"Rural CoCs"
"4514","MT","500","Montana Statewide CoC",1405,1032,373,422,350,72,134,112,22,2018,200,112,88,198,125,73,8,"Rural CoCs"
"4515","NC","500","Winston-Salem/Forsyth County CoC",440,407,33,89,89,0,27,27,0,2018,72,67,5,53,50,3,0,"Other Urban CoCs"
"4516","NC","501","Asheville/Buncombe County CoC",554,497,57,39,33,6,13,12,1,2018,82,61,21,247,242,5,4,"Suburban CoCs"
"4517","NC","502","Durham City & County CoC",338,285,53,92,92,0,29,29,0,2018,68,36,32,63,62,1,0,"Other Urban CoCs"
"4518","NC","503","North Carolina Balance of State CoC",2991,2023,968,917,718,199,301,236,65,2018,485,227,258,156,100,56,15,"Rural CoCs"
"4519","NC","504","Greensboro, High Point CoC",657,545,112,177,169,8,53,51,2,2018,36,36,0,55,55,0,13,"Other Urban CoCs"
"4520","NC","505","Charlotte/Mecklenberg CoC",1668,1459,209,535,535,0,167,167,0,2018,217,187,30,146,130,16,5,"Major Cities"
"4521","NC","506","Wilmington/Brunswick, New Hanover, Pender Counties CoC",333,206,127,62,62,0,20,20,0,2018,32,9,23,30,18,12,3,"Suburban CoCs"
"4522","NC","507","Raleigh/Wake County CoC",983,791,192,318,313,5,93,91,2,2018,121,50,71,80,63,17,2,"Major Cities"
"4523","NC","509","Gastonia/Cleveland, Gaston, Lincoln Counties CoC",331,205,126,83,69,14,27,24,3,2018,79,43,36,2,2,0,1,"Suburban CoCs"
"4524","NC","511","Fayetteville/Cumberland County CoC",372,147,225,230,133,97,73,42,31,2018,67,2,65,38,5,33,0,"Other Urban CoCs"
"4525","NC","513","Chapel Hill/Orange County CoC",152,113,39,32,30,2,10,9,1,2018,19,1,18,12,6,6,0,"Other Urban CoCs"
"4526","NC","516","Northwest North Carolina CoC",449,140,309,243,54,189,84,17,67,2018,15,12,3,2,2,0,0,"Rural CoCs"
"4527","ND","500","North Dakota Statewide CoC",542,494,48,75,75,0,27,27,0,2018,76,76,0,9,9,0,9,"Rural CoCs"
"4528","NE","500","Nebraska Balance of State CoC",559,524,35,232,227,5,76,75,1,2018,24,23,1,13,11,2,3,"Rural CoCs"
"4529","NE","501","Omaha, Council Bluffs CoC",1411,1347,64,289,289,0,106,106,0,2018,358,327,31,142,141,1,5,"Major Cities"
"4530","NE","502","Lincoln CoC",451,406,45,155,153,2,54,53,1,2018,73,48,25,16,16,0,6,"Other Urban CoCs"
"4531","NH","500","New Hampshire Balance of State CoC",742,620,122,275,268,7,95,92,3,2018,135,76,59,35,28,7,0,"Rural CoCs"
"4532","NH","501","Manchester CoC",427,401,26,223,218,5,79,77,2,2018,16,16,0,47,47,0,0,"Other Urban CoCs"
"4533","NH","502","Nashua/Hillsborough County CoC",281,275,6,117,117,0,41,41,0,2018,10,6,4,61,61,0,0,"Suburban CoCs"
"4534","NJ","500","Atlantic City & County CoC",437,306,131,36,36,0,12,12,0,2018,105,44,61,48,37,11,0,"Suburban CoCs"
"4535","NJ","501","Bergen County CoC",354,331,23,131,131,0,45,45,0,2018,11,8,3,19,18,1,10,"Suburban CoCs"
"4536","NJ","502","Burlington County CoC",840,784,56,383,379,4,110,109,1,2018,81,59,22,22,17,5,1,"Suburban CoCs"
"4537","NJ","503","Camden City & County/Gloucester, Cape May, Cumberland Counties CoC",999,854,145,294,286,8,94,92,2,2018,146,66,80,130,125,5,7,"Suburban CoCs"
"4538","NJ","504","Newark/Essex County CoC",2228,1832,396,861,854,7,299,296,3,2018,250,53,197,76,61,15,5,"Suburban CoCs"
"4539","NJ","506","Jersey City, Bayonne/Hudson County CoC",860,617,243,188,188,0,67,67,0,2018,226,66,160,26,18,8,0,"Suburban CoCs"
"4540","NJ","507","New Brunswick/Middlesex County CoC",597,466,131,242,242,0,75,75,0,2018,88,42,46,16,4,12,0,"Suburban CoCs"
"4541","NJ","508","Monmouth County CoC",335,263,72,148,148,0,45,45,0,2018,40,12,28,10,7,3,0,"Suburban CoCs"
"4542","NJ","509","Morris County CoC",398,363,35,149,149,0,49,49,0,2018,65,43,22,10,9,1,0,"Suburban CoCs"
"4543","NJ","510","Lakewood Township/Ocean County CoC",354,252,102,161,158,3,47,46,1,2018,52,19,33,10,4,6,7,"Suburban CoCs"
"4544","NJ","511","Paterson/Passaic County CoC",434,322,112,150,150,0,54,54,0,2018,95,45,50,10,2,8,0,"Suburban CoCs"
"4545","NJ","512","Salem County CoC",49,44,5,35,35,0,8,8,0,2018,3,0,3,0,0,0,0,"Suburban CoCs"
"4546","NJ","513","Somerset County CoC",218,212,6,66,66,0,25,25,0,2018,5,3,2,87,86,1,2,"Suburban CoCs"
"4547","NJ","514","Trenton/Mercer County CoC",479,416,63,142,142,0,47,47,0,2018,46,25,21,18,13,5,1,"Suburban CoCs"
"4548","NJ","515","Elizabeth/Union County CoC",478,437,41,269,258,11,88,85,3,2018,43,38,5,7,6,1,1,"Suburban CoCs"
"4549","NJ","516","Warren, Sussex, Hunterdon Counties CoC",338,276,62,95,83,12,28,25,3,2018,30,15,15,66,63,3,1,"Suburban CoCs"
"4550","NM","500","Albuquerque CoC",1340,956,384,225,209,16,69,64,5,2018,421,251,170,169,128,41,53,"Major Cities"
"4551","NM","501","New Mexico Balance of State CoC",1211,799,412,377,315,62,132,110,22,2018,470,289,181,121,49,72,20,"Rural CoCs"
"4552","NV","500","Las Vegas/Clark County CoC",6083,2199,3884,297,264,33,106,95,11,2018,505,189,316,594,429,165,214,"Major Cities"
"4553","NV","501","Reno, Sparks/Washoe County CoC",1192,1008,184,141,141,0,46,46,0,2018,106,71,35,119,99,20,14,"Other Urban CoCs"
"4554","NV","502","Nevada Balance of State CoC",269,98,171,48,27,21,15,10,5,2018,37,15,22,10,2,8,0,"Rural CoCs"
"4555","NY","500","Rochester, Irondequoit, Greece/Monroe County CoC",835,779,56,292,292,0,96,96,0,2018,90,80,10,73,65,8,13,"Suburban CoCs"
"4556","NY","501","Elmira/Steuben, Allegany, Livingston, Chemung, Schuyler Counties CoC",233,219,14,114,114,0,34,34,0,2018,0,0,0,0,0,0,0,"Rural CoCs"
"4557","NY","503","Albany City & County CoC",835,800,35,255,255,0,84,84,0,2018,99,72,27,84,81,3,2,"Suburban CoCs"
"4558","NY","504","Cattaragus County CoC",33,33,0,12,12,0,5,5,0,2018,0,0,0,1,1,0,0,"Rural CoCs"
"4559","NY","505","Syracuse, Auburn/Onondaga, Oswego, Cayuga Counties CoC",722,710,12,182,182,0,60,60,0,2018,36,34,2,41,41,0,14,"Suburban CoCs"
"4560","NY","507","Schenectady City & County CoC",393,382,11,179,179,0,54,54,0,2018,38,38,0,26,22,4,2,"Suburban CoCs"
"4561","NY","508","Buffalo, Niagara Falls/Erie, Niagara, Orleans, Genesee, Wyoming Counties CoC",957,942,15,345,345,0,108,108,0,2018,25,25,0,88,88,0,16,"Suburban CoCs"
"4562","NY","510","Ithaca/Tompkins County CoC",91,46,45,16,16,0,6,6,0,2018,5,1,4,8,3,5,0,"Rural CoCs"
"4563","NY","511","Binghamton, Union Town/Broome, Otsego, Chenango, Delaware, Cortland, Tioga Count",244,166,78,33,21,12,13,7,6,2018,21,11,10,17,17,0,9,"Rural CoCs"
"4564","NY","512","Troy/Rensselaer County CoC",178,172,6,78,78,0,26,26,0,2018,7,1,6,1,1,0,0,"Suburban CoCs"
"4565","NY","513","Wayne, Ontario, Seneca, Yates Counties CoC",182,163,19,0,0,0,0,0,0,2018,6,6,0,20,20,0,4,"Rural CoCs"
"4566","NY","514","Jamestown, Dunkirk/Chautauqua County CoC",145,142,3,51,51,0,15,15,0,2018,1,1,0,4,4,0,8,"Rural CoCs"
"4567","NY","516","Clinton County CoC",197,196,1,83,83,0,26,26,0,2018,13,13,0,4,4,0,0,"Rural CoCs"
"4568","NY","518","Utica, Rome/Oneida, Madison Counties CoC",178,162,16,78,71,7,25,23,2,2018,19,17,2,4,4,0,2,"Rural CoCs"
"4569","NY","519","Columbia, Greene Counties CoC",196,191,5,83,83,0,25,25,0,2018,4,4,0,0,0,0,0,"Rural CoCs"
"4570","NY","520","Franklin, Essex Counties CoC",42,42,0,17,17,0,5,5,0,2018,0,0,0,2,2,0,0,"Rural CoCs"
"4571","NY","522","Jefferson, Lewis, St. Lawrence Counties CoC",96,90,6,15,15,0,5,5,0,2018,2,0,2,7,7,0,0,"Rural CoCs"
"4572","NY","523","Glens Falls, Saratoga Springs/Saratoga, Washington, Warren, Hamilton Counties Co",257,234,23,32,30,2,12,11,1,2018,16,15,1,26,26,0,5,"Suburban CoCs"
"4573","NY","600","New York City CoC",78676,74965,3711,45285,45285,0,14261,14261,0,2018,6336,4867,1469,605,597,8,6,"Major Cities"
"4574","NY","601","Poughkeepsie/Dutchess County CoC",399,390,9,173,173,0,61,61,0,2018,26,22,4,5,5,0,6,"Suburban CoCs"
"4575","NY","602","Newburgh, Middletown/Orange County CoC",480,438,42,251,251,0,77,77,0,2018,101,76,25,17,11,6,5,"Suburban CoCs"
"4576","NY","603","Nassau, Suffolk Counties CoC",3868,3816,52,2876,2876,0,850,850,0,2018,117,98,19,135,134,1,15,"Suburban CoCs"
"4577","NY","604","Yonkers, Mount Vernon/Westchester County CoC",1827,1783,44,1216,1216,0,396,396,0,2018,164,150,14,45,42,3,7,"Suburban CoCs"
"4578","NY","606","Rockland County CoC",180,130,50,35,35,0,13,13,0,2018,37,16,21,3,3,0,0,"Suburban CoCs"
"4579","NY","607","Sullivan County CoC",189,180,9,65,63,2,20,19,1,2018,0,0,0,3,3,0,2,"Rural CoCs"
"4580","NY","608","Kingston/Ulster County CoC",464,432,32,304,298,6,91,89,2,2018,32,23,9,5,3,2,6,"Rural CoCs"
"4581","OH","500","Cincinnati/Hamilton County CoC",1114,1067,47,283,283,0,82,82,0,2018,70,64,6,161,158,3,14,"Suburban CoCs"
"4582","OH","501","Toledo/Lucas County CoC",662,640,22,259,257,2,78,77,1,2018,51,42,9,24,24,0,6,"Other Urban CoCs"
"4583","OH","502","Cleveland/Cuyahoga County CoC",1808,1730,78,431,431,0,123,123,0,2018,172,127,45,159,158,1,0,"Suburban CoCs"
"4584","OH","503","Columbus/Franklin County CoC",1807,1519,288,566,560,6,169,167,2,2018,137,41,96,100,86,14,4,"Major Cities"
"4585","OH","504","Youngstown/Mahoning County CoC",180,157,23,85,85,0,28,28,0,2018,25,21,4,12,10,2,3,"Other Urban CoCs"
"4586","OH","505","Dayton, Kettering/Montgomery County CoC",680,629,51,114,114,0,39,39,0,2018,30,28,2,52,51,1,5,"Suburban CoCs"
"4587","OH","506","Akron, Barberton/Summit County CoC",587,454,133,125,125,0,35,35,0,2018,46,8,38,64,56,8,14,"Suburban CoCs"
"4588","OH","507","Ohio Balance of State CoC",3133,2500,633,1324,1213,111,418,386,32,2018,196,94,102,162,141,21,5,"Rural CoCs"
"4589","OH","508","Canton, Massillon, Alliance/Stark County CoC",278,238,40,133,133,0,43,43,0,2018,3,0,3,15,10,5,0,"Suburban CoCs"
"4590","OK","500","North Central Oklahoma CoC",181,141,40,83,78,5,27,26,1,2018,7,6,1,1,0,1,4,"Rural CoCs"
"4591","OK","501","Tulsa City & County CoC",1083,857,226,207,199,8,67,64,3,2018,159,64,95,113,89,24,7,"Major Cities"
"4592","OK","502","Oklahoma City CoC",1183,789,394,243,198,45,82,68,14,2018,260,63,197,121,85,36,0,"Major Cities"
"4593","OK","503","Oklahoma Balance of State CoC",233,78,155,186,74,112,57,20,37,2018,42,17,25,5,3,2,1,"Rural CoCs"
"4594","OK","504","Norman/Cleveland County CoC",364,137,227,33,33,0,6,6,0,2018,303,76,227,15,5,10,0,"Suburban CoCs"
"4595","OK","505","Northeast Oklahoma CoC",392,341,51,160,133,27,50,41,9,2018,93,71,22,15,13,2,14,"Rural CoCs"
"4596","OK","506","Southwest Oklahoma Regional CoC",191,150,41,77,74,3,19,18,1,2018,0,0,0,29,4,25,0,"Rural CoCs"
"4597","OK","507","Southeastern Oklahoma Regional CoC",244,187,57,59,43,16,19,14,5,2018,44,33,11,14,7,7,9,"Rural CoCs"
"4598","OR","500","Eugene, Springfield/Lane County CoC",1641,507,1134,251,138,113,76,44,32,2018,712,112,600,173,53,120,25,"Other Urban CoCs"
"4599","OR","501","Portland, Gresham/Multnomah County CoC",4019,2351,1668,625,548,77,193,165,28,2018,1384,467,917,448,265,183,13,"Major Cities"
"4600","OR","502","Medford, Ashland/Jackson County CoC",732,403,329,108,96,12,39,35,4,2018,259,67,192,116,82,34,15,"Suburban CoCs"
"4601","OR","503","Central Oregon CoC",787,232,555,199,34,165,62,13,49,2018,172,23,149,60,24,36,15,"Rural CoCs"
"4602","OR","505","Oregon Balance of State CoC",6392,1858,4534,1973,615,1358,672,211,461,2018,1503,278,1225,474,128,346,243,"Rural CoCs"
"4603","OR","506","Hillsboro, Beaverton/Washington County CoC",522,163,359,115,72,43,39,26,13,2018,166,13,153,71,47,24,6,"Suburban CoCs"
"4604","OR","507","Clackamas County CoC",383,37,346,66,21,45,27,8,19,2018,125,0,125,21,1,20,0,"Suburban CoCs"
"4605","PA","500","Philadelphia CoC",5788,4705,1083,2199,2199,0,744,744,0,2018,943,516,427,239,203,36,36,"Major Cities"
"4606","PA","501","Harrisburg/Dauphin County CoC",445,410,35,185,185,0,64,64,0,2018,47,38,9,39,33,6,0,"Suburban CoCs"
"4607","PA","502","Upper Darby, Chester, Haverford/Delaware County CoC",414,361,53,180,180,0,58,58,0,2018,33,14,19,6,6,0,0,"Suburban CoCs"
"4608","PA","503","Wilkes-Barre, Hazleton/Luzerne County CoC",165,159,6,70,70,0,24,24,0,2018,0,0,0,9,9,0,0,"Suburban CoCs"
"4609","PA","504","Lower Merion, Norristown, Abington/Montgomery County CoC",291,271,20,150,150,0,44,44,0,2018,20,17,3,8,8,0,0,"Suburban CoCs"
"4610","PA","505","Chester County CoC",579,566,13,214,214,0,69,69,0,2018,11,11,0,206,206,0,0,"Suburban CoCs"
"4611","PA","506","Reading/Berks County CoC",562,551,11,156,156,0,51,51,0,2018,5,4,1,39,39,0,0,"Suburban CoCs"
"4612","PA","508","Scranton/Lackawanna County CoC",159,154,5,59,59,0,19,19,0,2018,12,11,1,33,33,0,0,"Suburban CoCs"
"4613","PA","509","Eastern Pennsylvania CoC",1998,1652,346,890,870,20,288,282,6,2018,91,67,24,97,85,12,14,"Rural CoCs"
"4614","PA","510","Lancaster City & County CoC",406,390,16,180,180,0,56,56,0,2018,22,12,10,32,30,2,0,"Suburban CoCs"
"4615","PA","511","Bristol, Bensalem/Bucks County CoC",397,378,19,203,203,0,68,68,0,2018,25,22,3,13,10,3,0,"Suburban CoCs"
"4616","PA","512","York City & County CoC",324,291,33,157,154,3,47,46,1,2018,13,8,5,11,9,2,0,"Suburban CoCs"
"4617","PA","600","Pittsburgh, McKeesport, Penn Hills/Allegheny County CoC",783,727,56,274,274,0,85,85,0,2018,117,97,20,115,112,3,0,"Suburban CoCs"
"4618","PA","601","Western Pennsylvania CoC",748,710,38,277,270,7,89,87,2,2018,46,37,9,102,97,5,0,"Rural CoCs"
"4619","PA","603","Beaver County CoC",117,111,6,50,50,0,15,15,0,2018,3,0,3,4,3,1,0,"Suburban CoCs"
"4620","PA","605","Erie City & County CoC",336,332,4,105,105,0,39,39,0,2018,20,17,3,29,27,2,0,"Suburban CoCs"
"4621","RI","500","Rhode Island Statewide CoC",1101,1050,51,354,352,2,121,120,1,2018,264,247,17,103,100,3,0,"Suburban CoCs"
"4622","SC","500","Charleston/Low Country CoC",451,337,114,94,83,11,27,24,3,2018,86,53,33,119,106,13,0,"Suburban CoCs"
"4623","SC","501","Greenville, Anderson, Spartanburg/Upstate CoC",1185,849,336,269,225,44,85,72,13,2018,181,95,86,79,57,22,4,"Suburban CoCs"
"4624","SC","502","Columbia/Midlands CoC",1205,1005,200,251,239,12,84,80,4,2018,248,166,82,146,124,22,4,"Suburban CoCs"
"4625","SC","503","Myrtle Beach, Sumter City & County CoC",1092,398,694,237,74,163,77,24,53,2018,171,38,133,71,33,38,4,"Rural CoCs"
"4626","SD","500","South Dakota Statewide CoC",1159,874,285,323,276,47,105,91,14,2018,190,134,56,110,89,21,4,"Rural CoCs"
"4627","TN","500","Chattanooga/Southeast Tennessee CoC",623,330,293,125,120,5,28,26,2,2018,322,136,186,56,22,34,0,"Rural CoCs"
"4628","TN","501","Memphis/Shelby County CoC",1226,1124,102,348,348,0,109,109,0,2018,87,79,8,231,218,13,34,"Major Cities"
"4629","TN","502","Knoxville/Knox County CoC",743,557,186,69,51,18,25,19,6,2018,177,54,123,66,66,0,5,"Suburban CoCs"
"4630","TN","503","Central Tennessee CoC",268,244,24,83,79,4,30,28,2,2018,46,36,10,38,35,3,1,"Rural CoCs"
"4631","TN","504","Nashville-Davidson County CoC",2298,1682,616,195,195,0,61,61,0,2018,637,200,437,259,172,87,5,"Major Cities"
"4632","TN","506","Upper Cumberland CoC",258,212,46,108,91,17,32,28,4,2018,9,5,4,8,7,1,0,"Rural CoCs"
"4633","TN","507","Jackson/West Tennessee CoC",1026,122,904,420,37,383,115,13,102,2018,72,6,66,5,2,3,0,"Rural CoCs"
"4634","TN","509","Appalachian Regional CoC",360,250,110,69,69,0,22,22,0,2018,51,30,21,37,21,16,3,"Rural CoCs"
"4635","TN","510","Murfreesboro/Rutherford County CoC",283,209,74,54,50,4,18,17,1,2018,100,28,72,17,6,11,0,"Suburban CoCs"
"4636","TN","512","Morristown/Blount, Sevier, Campbell, Cocke Counties CoC",798,298,500,273,135,138,86,43,43,2018,162,35,127,25,7,18,1,"Rural CoCs"
"4637","TX","500","San Antonio/Bexar County CoC",3066,1713,1353,801,801,0,232,232,0,2018,479,225,254,228,168,60,0,"Major Cities"
"4638","TX","503","Austin/Travis County CoC",2147,1133,1014,552,546,6,159,157,2,2018,498,173,325,170,102,68,11,"Major Cities"
"4639","TX","600","Dallas City & County, Irving CoC",4121,2780,1341,934,927,7,301,299,2,2018,587,432,155,320,254,66,43,"Major Cities"
"4640","TX","601","Fort Worth, Arlington/Tarrant County CoC",2015,1337,678,410,401,9,133,129,4,2018,278,171,107,159,128,31,10,"Major Cities"
"4641","TX","603","El Paso City & County CoC",892,715,177,320,320,0,98,98,0,2018,151,126,25,81,58,23,9,"Major Cities"
"4642","TX","604","Waco/McLennan County CoC",188,130,58,71,71,0,20,20,0,2018,22,4,18,23,13,10,0,"Rural CoCs"
"4643","TX","607","Texas Balance of State CoC",7638,3560,4078,1871,1671,200,566,514,52,2018,644,135,509,451,144,307,31,"Rural CoCs"
"4644","TX","611","Amarillo CoC",665,558,107,70,70,0,27,27,0,2018,47,0,47,45,38,7,0,"Other Urban CoCs"
"4645","TX","624","Wichita Falls/Wise, Palo Pinto, Wichita, Archer Counties CoC",238,195,43,26,23,3,9,8,1,2018,19,9,10,15,12,3,13,"Rural CoCs"
"4646","TX","700","Houston, Pasadena, Conroe/Harris, Ft. Bend, Montgomery, Counties CoC",4143,2529,1614,981,981,0,340,340,0,2018,669,233,436,443,225,218,2,"Major Cities"
"4647","TX","701","Bryan, College Station/Brazos Valley CoC",197,126,71,75,48,27,32,21,11,2018,10,6,4,0,0,0,0,"Other Urban CoCs"
"4648","UT","500","Salt Lake City & County CoC",1804,1668,136,620,620,0,177,177,0,2018,227,183,44,187,180,7,2,"Suburban CoCs"
"4649","UT","503","Utah Balance of State CoC",899,660,239,294,292,2,91,90,1,2018,56,29,27,47,40,7,11,"Suburban CoCs"
"4650","UT","504","Provo/Mountainland CoC",173,128,45,58,58,0,19,19,0,2018,23,7,16,5,2,3,5,"Suburban CoCs"
"4651","VA","500","Richmond/Henrico, Chesterfield, Hanover Counties CoC",609,505,104,124,124,0,49,49,0,2018,90,68,22,92,82,10,0,"Suburban CoCs"
"4652","VA","501","Norfolk/Chesapeake, Suffolk, Isle of Wight, Southampton Counties CoC",773,693,80,211,211,0,66,66,0,2018,90,78,12,77,69,8,0,"Suburban CoCs"
"4653","VA","502","Roanoke City & County, Salem CoC",317,306,11,89,89,0,28,28,0,2018,36,35,1,37,37,0,0,"Suburban CoCs"
"4654","VA","503","Virginia Beach CoC",243,171,72,45,36,9,14,12,2,2018,40,30,10,33,24,9,8,"Major Cities"
"4655","VA","504","Charlottesville CoC",183,155,28,41,41,0,11,11,0,2018,41,28,13,14,9,5,0,"Rural CoCs"
"4656","VA","505","Newport News, Hampton/Virginia Peninsula CoC",439,369,70,123,123,0,41,41,0,2018,63,50,13,58,52,6,0,"Other Urban CoCs"
"4657","VA","507","Portsmouth CoC",135,107,28,51,51,0,21,21,0,2018,13,6,7,12,8,4,0,"Other Urban CoCs"
"4658","VA","508","Lynchburg CoC",112,92,20,28,28,0,9,9,0,2018,8,2,6,10,8,2,0,"Rural CoCs"
"4659","VA","513","Harrisburg, Winchester/Western Virginia CoC",304,276,28,87,84,3,26,25,1,2018,42,42,0,15,12,3,0,"Rural CoCs"
"4660","VA","514","Fredericksburg/Spotsylvania, Stafford Counties CoC",200,164,36,72,69,3,20,19,1,2018,36,23,13,22,18,4,0,"Suburban CoCs"
"4661","VA","521","Virginia Balance of State CoC",718,553,165,297,262,35,98,86,12,2018,38,12,26,36,28,8,0,"Rural CoCs"
"4662","VA","600","Arlington County CoC",221,186,35,77,77,0,28,28,0,2018,57,30,27,8,6,2,0,"Other Urban CoCs"
"4663","VA","601","Fairfax County CoC",987,901,86,488,488,0,151,151,0,2018,173,119,54,33,22,11,2,"Suburban CoCs"
"4664","VA","602","Loudoun County CoC",134,110,24,48,48,0,15,15,0,2018,28,21,7,6,6,0,0,"Suburban CoCs"
"4665","VA","603","Alexandria CoC",226,211,15,84,84,0,29,29,0,2018,60,51,9,8,8,0,0,"Other Urban CoCs"
"4666","VA","604","Prince William County CoC",374,261,113,182,179,3,54,53,1,2018,82,27,55,24,11,13,2,"Suburban CoCs"
"4667","VT","500","Vermont Balance of State CoC",932,867,65,407,394,13,136,132,4,2018,118,104,14,79,72,7,6,"Rural CoCs"
"4668","VT","501","Burlington/Chittenden County CoC",359,342,17,104,104,0,33,33,0,2018,42,34,8,25,24,1,0,"Other Urban CoCs"
"4669","WA","500","Seattle/King County CoC",12112,5792,6320,2624,2545,79,782,757,25,2018,3552,1038,2514,921,392,529,172,"Major Cities"
"4670","WA","501","Washington Balance of State CoC",5666,3177,2489,1936,1508,428,593,465,128,2018,1493,300,1193,390,215,175,32,"Rural CoCs"
"4671","WA","502","Spokane City & County CoC",1245,935,310,328,313,15,119,115,4,2018,265,159,106,96,67,29,20,"Other Urban CoCs"
"4672","WA","503","Tacoma, Lakewood/Pierce County CoC",1628,878,750,404,384,20,128,120,8,2018,366,188,178,140,60,80,14,"Suburban CoCs"
"4673","WA","504","Everett/Snohomish County CoC",858,480,378,246,213,33,74,66,8,2018,367,97,270,52,20,32,24,"Suburban CoCs"
"4674","WA","508","Vancouver/Clark County CoC",795,421,374,342,201,141,104,60,44,2018,115,55,60,37,16,21,11,"Suburban CoCs"
"4675","WI","500","Wisconsin Balance of State CoC",3147,3020,127,1650,1630,20,502,495,7,2018,285,273,12,165,161,4,4,"Rural CoCs"
"4676","WI","501","Milwaukee City & County CoC",871,710,161,213,208,5,67,65,2,2018,96,64,32,85,79,6,13,"Major Cities"
"4677","WI","502","Racine City & County CoC",275,265,10,99,99,0,28,28,0,2018,22,20,2,38,38,0,0,"Suburban CoCs"
"4678","WI","503","Madison/Dane County CoC",614,530,84,205,205,0,63,63,0,2018,124,92,32,44,43,1,5,"Other Urban CoCs"
"4679","WV","500","Wheeling, Weirton Area CoC",108,98,10,25,25,0,9,9,0,2018,21,13,8,8,6,2,0,"Rural CoCs"
"4680","WV","501","Huntington/Cabell, Wayne Counties CoC",190,169,21,41,41,0,13,13,0,2018,6,3,3,14,12,2,0,"Rural CoCs"
"4681","WV","503","Charleston/Kanawha, Putnam, Boone, Clay Counties CoC",317,260,57,41,41,0,15,15,0,2018,31,17,14,16,11,5,10,"Suburban CoCs"
"4682","WV","508","West Virginia Balance of State CoC",628,533,95,115,111,4,36,35,1,2018,96,51,45,93,77,16,0,"Rural CoCs"
"4683","WY","500","Wyoming Statewide CoC",639,440,199,205,141,64,77,56,21,2018,46,42,4,47,47,0,16,"Rural CoCs"
"4684",NA,NA,"Total",552830,358363,194467,180413,164023,16390,56342,51513,4829,2018,96913,36575,60338,37878,23312,14566,4093,NA
